--------------------------------------------------------------------------------------------------------------------------------------------------------------------------------------------------------
--------------------------------------------------------------------------------------------------------------------------------------------------------------------------------------------------------
--------------------------------------------------------------------------------------------------------------------------------------------------------------------------------------------------------
--------------------------------------------------------------------------------------------------------------------------------------------------------------------------------------------------------
--------------------------------------------------------------------------------------------------------------------------------------------------------------------------------------------------------
--------o----------------------------o------------------------------o-----------------------------------------------------------------------------------------------------------------------------------
--------------------------------------------------------------------------------------------------------------------------------------------------------------------------------------------------------
-------o----------------------------------------------------------------------------------------------------------------------o--------------------------o---------------------------------------------v
---X?X-M-------------------------X?X-----------------M-X?X-------------------------X?X---------------------------X?X-------------------------------------------------------X?X-------------X?X------M--f
-M-----M--------X?X-------------------------X?X----------X?X---------X?X---MX?X-------------------------M-----M-MM--------X?X-------X?X-------X?X-------X?X--M---M-X?X----M----X?X?X-------------------f
--?X--X?X--------MM----X?X--------------------M---X?X-----M----------------------------X?X------M--M---------X?X-M--X?X--X?X-------X?X-------------------------------M----MX?X-------------------------f
------X?X-------M---X?X-----M-X?X---M-----MX?X-X?X------X?X---M---M---------------X?X-----------X?X------X?X--------X?X?XX?X----MX?X?X--------------------M-M-M--------X?X-----------------------X?X---f
---------X?X--------M---------M------X?X--M--M----M-M--------X?X---M-------X?X------X?X?X------M-------X?X--------X?X------------X?X---------M-X?XX?XX?X---M------X?X-X?X-------------------X?XM---X?X-f
--?X------------M---X?X--------X?X---------------------------------------MX?X-M-----X?X--------------------M-X?X---M-------M-M----M--------X?X--MX?X------X?X---------------------------------------XM-f
m-E---M-M----M--E-E-----------E---------------M--E--E-E-----------M---------M-------E--E-E--------E----EE-----ME-------M-----M--E-----E-----E-----E-----M--M-----MM-E-----ME--------------------------MX
XXXXXXXXXXXXXXXXXXXXXXXXXXXXXXXXXXXXXXXXXXXXXXXXXXXXXXXXXXXXXXXXXXXXXXXXXXXXXXXXXXXXXXXXXXXXXXXXXXXXXXXXXXXXXXXXXXXXXXXXXXXXXXXXXXXXXXXXXXXXXXXXXXXXXXXXXXXXXXXXXXXXXXXXXXXXXXXXXXXXXXXXXXXXXXXXXXXXXXXX
