------------------o---------------------------------------o-------------------------------------------------------o-------------------------------------------------o--------o--------------------------
----------------------o-----------------------------------------------------------------------------------------o-------------------------------------------------------------------o-------------------
----------------------------------------------------------------------o----------------------------------------------------------------------------------------o----------------------------------------
------------------------------------------------------------------------------------------------o------------------------------------------------------------o--------------------o---------------------
-------------------------------------------------o------------------------------------------o-o---------------o-----------------------------------------------------------------------------------------
-----------------------o-----------------------o-o----------------------------------------o--------------------------------------------------------------------------------------o----------------------
--------------------------------------------------------------o-------------------------------------------------------------------------------------------------------------------o-----o---------------
-----------------------------------------------------------------------------------------------------------o-------------------------------------------------------------------------------------------v
----M---------M-------------------------------------------------X?X-----------------X?X------------------------M---X?X------------------------------M--------------------------------------------------f
-----------M---------------------------------------------------------------------------------M---------------M---------X?X-----------------------------------------------------------------------------f
--------------------------------------------------------M---------------------------------------X?X------------X?X--------------------X?X--------------------------------------------------------------f
---------------X?X----M--------------------------------------------------------------------------M-------------X?X-----------X?X-----------X?X---------------X?X---------------------------------------f
-----------------------------M----------------X?X-------------------------------X?X-----------------------------------M-----------------X?X------------------------------------------------------------f
-----------------------------------------------------------------X?X-------------------------------------------------------------------X?X-------------------------------------------------------------f
m---------------------------------------X?X------------------------M--------X?X--------------------------------E--------M------------------------------------------M-----------------------------------X
XXXXXXXXXXXXXXXXXXXXXXXXXXXXXXXXXXXXXXXXXXXXXXXXXXXXXXXXXXXXXXXXXXXXXXXXXXXXXXXXXXXXXXXXXXXXXXXXXXXXXXXXXXXXXXXXXXXXXXXXXXXXXXXXXXXXXXXXXXXXXXXXXXXXXXXXXXXXXXXXXXXXXXXXXXXXXXXXXXXXXXXXXXXXXXXXXXXXXXXX
