----------------------------------------------------------------------------------------------------------------------------------------------o------------o--------------------------------------------
-------------------------------------------------o------------------------------------------------------------------------------------------------------------------------------------------------------
-------------------------------------------------------------------------------------------------------------------------o------------------------------------------------------------------------------
----------------------------------------------------------------------------------------------------------------------------------------------------o---------------------------------o-----------------
-----------------------------------------------------------------------------o----------------------------------------------------------------------------------------------------------------o---------
--------------------------------------------------------------------------------------------------------------------------------------------------------------------------------------------------------
------------------------------------------o-----------------------------------------------------------------o---------------------------------------------o---------------------------------------------
-------------o----------------------------------------------------o-----------------------------------------o-----------------------------------------o------------------------------------------------v
-----------------------------------------------------------------M-------------------------M------------------X?X-------------------------------------------M--------------------------------------M---f
---------M------------X?X--------------------X?X------X?X--------------------------------------------------------------------------------------------------------------------M-------------------------f
------------------------------X?X-------------------------------M---------------------------------------X?X----------------------------------M--------------------------------M------X?X---------------f
-------------------X?X--------------------------------------------------------------------------------------------------------------------------------------------------------------X?X------X?X-------f
------------------------------------------------------------------------------------------------------------M-------M--------X?X----------------------------------------------------------------M------f
--------------------------------------------X?X-------------------M---------------------------------------------X?X------------------------------------------------------------------------------------f
m------------M------------------------------------------E--------------------------------------------------------E-------------------------------E-E--------X?X----------------------------------------X
XXXXXXXXXXXXXXXXXXXXXXXXXXXXXXXXXXXXXXXXXXXXXXXXXXXXXXXXXXXXXXXXXXXXXXXXXXXXXXXXXXXXXXXXXXXXXXXXXXXXXXXXXXXXXXXXXXXXXXXXXXXXXXXXXXXXXXXXXXXXXXXXXXXXXXXXXXXXXXXXXXXXXXXXXXXXXXXXXXXXXXXXXXXXXXXXXXXXXXXX
