---------M?-----------------M------E------E-----------------------M--E-------M-----------------------------------------------------------M--E-------------?------------M--------M-?---------------------
---------?--------------------------------------------------E-------------------------------------E------------------------------------------------------M---M----E-------------------------------------
---E-----------------------------?-------------------------------M--------------------------M---------------------------------------------------------------------------------------------?-------------
-----------------?--?---M---------------------------------------------?---------------------------------------------------------------------------------E-----------------------------------------------
------M-?--------M-M---------------------------------------------------------------M---------------------------------M-----E--------------------E-------------------------------------------------------
-----------------------?-------------------------------------------------------?------------------------------------------------------------------------------------------EE----------------------------
---------------------------------E---------------------------------------------?------?------------------M---------E--------?---------------------------------------------------------------------------
-------M-----------------------------------?--------------------?-----------------------------------?-------------------------------------------------------------------M----------------M?------------v
---------?----------------------------------M----------??---------------------------------------M----------------M-------------------------------------------?-----------------------------------------f
----------------------------?-------?-----------------?------------------------------------------------------------------------------------------------------------------------------------------------f
--------M---?------?--M-------------------------------------------------------------------------------------------------M----------------------M--------------?----------M-----------------------M-----f
--------?----------------------------------------------------------------------------------------------?----------------------------------?-----------------------------------------------?--------?---f
--------------------------------------------------------------------------------------------M-------------------------------M-----?----------------------------------------------------------------E---f
------------------------------------?-------------------------------------------------------------------------------------------------------------------------------E----------------------------------f
m?----------E--------?---------------E-------------------?--------------------------------------------------------------------------E---------------?--E---E--M-----------------------------------?----X
XXXXXXXXXXXXXXXXXXXXXXXXXXXXXXXXXXXXXXXXXXXXXXXXXXXXXXXXXXXXXXXXXXXXXXXXXXXXXXXXXXXXXXXXXXXXXXXXXXXXXXXXXXXXXXXXXXXXXXXXXXXXXXXXXXXXXXXXXXXXXXXXXXXXXXXXXXXXXXXXXXXXXXXXXXXXXXXXXXXXXXXXXXXXXXXXXXXXXXXX
