------o---o-------o--------o----------------------------------------------------------------------------------------------------------------------------------o-----------------------------------------
---------------------------------------------------------------o-------------------------------------------o--------------------------------------------------------------------------------------------
--------------------------------------------------------------------------------------------------------------------------o-----------------------------------------------------------------------------
---------------------------------------------------------------------------------------------------------------------------------------------------------o----------------------------------------------
--------------------------------------------------------------------------------------------------------------------------------------o------------------o---------------------o------------------------
-------o------------------------------------------o-------------o---------------------------------------------------------------------------------------------------------------------------------------
------------o-----------------------------------------------------------------------------------------------------------------------o-----o-------------------------------------------------------------
--------------------------------------------------o------------------------------------------------------------------o-------------o----------------------oo-------------------------------------------v
-----------------------------------------------------------------------------------------------------X?X-----------------------------------------------------------------------------------------------f
---------------------------------------------------------X?X--------------------------X?X-----X?X------------------------X?X--M------------------------------------------------------------------------f
---------------------------------------------------------------------------------------M--------------M--------------------------------M------X?XM--------------------X?X------------------------------f
----------X?X-------M-----------------------------------------------------------------------X?X-------------------------------------------------X?X----------------------------------------M-----------f
--------------M--------M-------------M----------------------------------------------M------------------------------------------------------------------------------------------------------------------f
------X?X------------X?X------------------------X?X------M-------------------------------------------------------X?X----------------------------------------------------------X?X----------------------f
m------------------E-----X?X--M-E---------------X?X------------------------E---------X?X---------------------------------------E--M-------------------------------------------------------------X?X--M-X
XXXXXXXXXXXXXXXXXXXXXXXXXXXXXXXXXXXXXXXXXXXXXXXXXXXXXXXXXXXXXXXXXXXXXXXXXXXXXXXXXXXXXXXXXXXXXXXXXXXXXXXXXXXXXXXXXXXXXXXXXXXXXXXXXXXXXXXXXXXXXXXXXXXXXXXXXXXXXXXXXXXXXXXXXXXXXXXXXXXXXXXXXXXXXXXXXXXXXXXX
