-------------------------------o-----------------------------------------------------------------------------------------------------------------------------------------------------------o------------
---o------------o---------------------------------------------------------------------------------------------------------------------------------------------------------------------------------------
--------------------------------------------------------------------------------------------------o-----------------------------------------------------------------------------------------------------
--------------------------------------------------------------------------------------------------o-----------------------------------------------------------------------------------------------------
-----------------------------------------------------------------------------------------------------------------o--------------------------------------------------------------------------------------
-------------------------------------o------------------------------------------------------------------------------------------------------------------------------------------------------------------
-----------------------------------------------------------------------------------------------------------------------------------o------------------------------o-------------------------------------
------------------------------------------------------------------------------------------------------------------------------------------------o------------------------------------------------------v
------------------------------M--------------------------------------------------------------M---------------------------M------------------X?X------------------------------M-------------------------f
-------------M------------------------------------------------------------------------------------X?X--------------------M-----------------------------------------------------------------------------f
------X?X-------------------------------------------------------------------------------------------------------------------------------------M--------------------------------------------------------f
----------------------------M--------------------------------------M-----------------------------------------------------------------------------------------------------------------------------------f
-------------------------X?X-----------------X?X-----------------------------------------X?XM------------------------------------------------X?X--------------------------------------X?X--------------f
-----------------X?X---------------------------------------------------------------------------------------------------------------------------------------------X?X-----------------------------------f
m-----E-----------E--------------M------E----E--------E------------------------------------------MM-E---------------------------M----------------------------------------------------------------------X
XXXXXXXXXXXXXXXXXXXXXXXXXXXXXXXXXXXXXXXXXXXXXXXXXXXXXXXXXXXXXXXXXXXXXXXXXXXXXXXXXXXXXXXXXXXXXXXXXXXXXXXXXXXXXXXXXXXXXXXXXXXXXXXXXXXXXXXXXXXXXXXXXXXXXXXXXXXXXXXXXXXXXXXXXXXXXXXXXXXXXXXXXXXXXXXXXXXXXXXX
