-?-----------o--------------------------------------------------------o---o-------------------------o-----------------------------------o----------o--------------------o--?-----------------o----------
----------------------------o----------------------o-----------o-------------------------o---------o--o---o---o---------------o----------------------------------------------------o--------------------
-?-------------o----------------------------------o---------------o--------------------------------------o------------o---------------------------------------------------------------------------------
---------------------------------------------o----o----------------o------o---------------o------------------o-----------o----o------o-----o-------------------------------------o----------o-----------
-------------oM---------------------------------o-------o------------------------o--------------------------------------M--------------------o---o---------------------o--o-----------------------------
--------------------------------------------------------------------?o-----------------------M---------------------------------------------------------------------o------------------------------------
-----o-----------------------------------o-------------------------o------oo---o-------------------o--------------------------------?---o--o------------------------------------------------------------
--------------o---o--------------?-----------M----------------------------------------------------------------------------------------------------?-----------------------o----------------------------v
---------X----------------X-----------------X---MX----?----X--------------M-----X-------------------------------------------X-----------------------------M----------------------------------X---------f
------------X------------X------------X-----------X------------X------?----------------------------?--X------X--X------------------------------------------?-------------X----------------X------------f
------------------------------------------M------------------------------------------X------X-------------------------------X--------------------------?----------------------?--------?--X------------f
---------M----------------?---------------------------------------?-----------------------------------------X-X---------------------------------------------------------------X------------------------f
------------------X------------------------------------------------X----------M------------------------------------------------X--------------XX------X------------X------XX---------------------------f
------------------X---------X------------------------------------------------X---------X---------------X----X-----------M---------------------------------------------------------?--M-----M-----------f
m------E-----------M-----------------E-----------------E---E-----------------X---X-----------------------------M--------X-------------------------X------E----E--------X--------------------------E---XX
X----XXX-X---X-X-X-X-X----X------XX-X-------XX---X-X--X---X--X--XX---X-X----------X-X--X------X--X-X----X-X--------X-X------X-X--X-X----X-X---------X-------------X----X-X--------X-----X--X-X-----X-X-X
