-------------------E---------------------------------E------------E--E----E---------------------------E-----E-----------------------------E-E---------------------------E---E--E------------------------
-----------------------------------E--------------------------------------------------E----------------------------------------------E--E----E----------------------------------------------------------
--E-----------------------------------------------------------------------------------E----------------------------------E--------E-----------E----------------------E----------------------------------
---------------------------------------E-----------------------------------------------------------------E--------------------------------------------------E---------------E---------------------------
-----------------------E----------------------------------------------E------------------------------E----------------E---------------------------------------------------------------------------------
----------E------------------------------------E-----------------E--------------------------------------------------------------------------------------------------------------------------------------
--E------------------------------------------------------------------------------EE-------------------------------E-------------------------------------------------E-----------------------------------
------------------------------E------------E------------------------------------------------------------------------------------E----------------------------------------------------------------------v
------------------------------------------------------------------E----------------------------------------------------------------E-------------------------------------------------------------------f
-------------------------------------------------E-------------------------------------------E---------------------------------------------------------------------------------------------------------f
-------------------------------------------------------------------------------------------------------------------------E------------------------------------------------EE-----------E---------------f
---------------------------------E--------------------------------------E------------------------------------------------------------------------------------------------------------------------------f
----------E---------------E------------------------E---------------------------------------------------------------------------------------------------------------------------------------------------f
------------------------------------------------------------------E-----------------------------------------------------------------------------------------------E------------------------------------f
mE----E---E--------------------------------------------------------------------------------------------------------------------------------------------------------------------------------------------X
XXXXXXXXXXXXXXXXXXXXXXXXXXXXXXXXXXXXXXXXXXXXXXXXXXXXXXXXXXXXXXXXXXXXXXXXXXXXXXXXXXXXXXXXXXXXXXXXXXXXXXXXXXXXXXXXXXXXXXXXXXXXXXXXXXXXXXXXXXXXXXXXXXXXXXXXXXXXXXXXXXXXXXXXXXXXXXXXXXXXXXXXXXXXXXXXXXXXXXXX
