--------E-----------------------------EM------------------------------------E-----------------------M---M----E--------?---M-----------E-------------------?---------------------M-------------E-E-M-----
------------------------?-------------------------------------------M-------------------------------------------------------E--------------E-------------?----------------------------------------------
---------------------?------------------------------------?----------------------------M-------E?-------------E-----------------------------------------------------------------------------------------
------------------------M---?------------------------E-----------------------------------------------------------------------------------M----------------------------M-----?-------------?-------------
-------------------E----------------------------------------E---M---------------------------------------E-------------------------------------------E---------E------------------------------M--------?-
--------------------------------------------E--------------E-----------------------?----?------------------------E----------?--------------------------------------M------------------------------------
---------------------------?-------------------M---------------------------------------M---M--------------------------------------------------?---------------------------------------------------------
-------------------------M-------------------------------------------M--------------------------------------------------------------------------------------------------------------M------------------v
------------------?-----------------------------------------------------------M--------------------------M-----------------------------------------------------------------------E--E------------------f
------------------E-----------------------E---------------------------------M-----------------------E----------?--------------------------------------------------M-?----------------------------------f
------------------------------------------------------------------------------------------------------------------?-----------------?-----------------------------------------------------E------------f
--------?-----M-----------------------?---------------------------------------------------------------------------------------------------------E--------------------M---------------------------------f
-------------M-----?---------------------?---M--------------------------?----------M--------------------------M------------------E-----------------------------------?---------------------------------f
----?-------------------?---------------------E---------------?---------------?-?--------------------M-------------------------------------------------------------------------------------------------f
m-?-----------?--E------?-----E--M-----------E------------------------------------------------------------------?-------------------------------------------------------------------------?----E-------X
XXXXXXXXXXXXXXXXXXXXXXXXXXXXXXXXXXXXXXXXXXXXXXXXXXXXXXXXXXXXXXXXXXXXXXXXXXXXXXXXXXXXXXXXXXXXXXXXXXXXXXXXXXXXXXXXXXXXXXXXXXXXXXXXXXXXXXXXXXXXXXXXXXXXXXXXXXXXXXXXXXXXXXXXXXXXXXXXXXXXXXXXXXXXXXXXXXXXXXXX
