-------------M---------o---o---M--o----------------------------o-------------------------?M-------------------o-----Mo----?----o--------------------------------------------?-------Mo-?---------M------
-------o-------------o------------------------------------o--------------------------------------------------------------------------------o---------------?-------------o-------------------o------o---
--------------------------------------?-------------o-----------------------------------o------oo---o-------o-----------------------------o----o-------------------------------------------o------------
--------------------------------------------------------------------------o--------------------------------------------------M--------------------------o------------------------o----------------------
--------------------o---o---o------o--------o------------------------------------o--------------------M-----------o--o------o-------o--------------------------------------------------------o----------
----------------------------o------------o---------o-o---------o-----------o----------------------------------------------------------------------------------------------------------------------------
-------o---?-------------o-----------------------------------------------------o--------------o----------------------------------------------o-o--o-----------------------------------o-----------------
--------------------------------------------o-?--------------o---------------------------------------------------o-----o--------o--------------------------------o----------o--oo----------------------v
----------X----------------X------------------------------X-----------------------------X-------X--X--------X-X---------------X-------------X-------------X----------------------------------X---?-----f
---X------------X------------X----------------------------------------?------------------------------X---------------X----X-------------------------------------------X------------X-------------X-----f
-----------------------------------------------X--X--------------------XX------------------------------------------?X--------------------------------------------X-----------------------------------X-f
----X-----------X-----------------------X-----------X-X---------?-----M------------X---------X-------------------------------------------------------------------X-------X--------X--------------------f
--------------------------------------X-----------------X---?---M---------X------------X-----------------------X----------------------------M---------------X----M---------------------------X-----X---f
-----------------------------------------------------------------------M------------------------------------------X----------------------M----------------------X------------------------------------X-f
m---------X--------------X------------X----E----E------------------E--------E----------E------E---------E------------X----------X------------XEX-E----------X---------E-M----------------X-------------X
X---X----X-X----X-----XX-XX--------X--X--X-XX-----X--------X-X--X-X---X--X--XX-XX----XX------X-X-X--X--X-X----X--X---XXX---X--X-----X---X-----X---XXXX----X----X----X-------X-X-XXX----X---XXXX--X---X-X
