--------------------------------------------------------------------------------------------------------------------------------------------------------------------------------------------------------
--------------------------------------------------------------------------------------------------------------------------------------------------------------------------------------------------------
--------------------------------------------------------------------------------------------------------------------------------------------------------------------------------------------------------
--------------------------------------------------------------------------------------------------------------------------------------------------------------------------------------------------------
--------------------------------------------------------------------------------------------------------------------------------------------------------------------------------------------------------
--------o----------------------------o------------------------------o-----------------------------------------------------------------------------------------------------------------------------------
--------------------------------------------------------------------------------------------------------------------------------------------------------------------------------------------------------
-------o----------------------------------------------------------------------------------------------------------------------o--------------------------o---------------------------------------------v
--X?XX-M---------------M---------X?X-------------------X?X--X?X--------------------X?X-----------M---------------X?X-------------------M--------------------------X?X------X?X-------------X?X---------f
-MM------------M--X?X---------------------M-----------------------------------------------------X?X-----M-------X?X--M----X?X------X?XX----------------------------X?X---------------------------------f
--?X------------M------X?X-------------M------MM--X?X-------------------M----X?X-------X?X----------M-----M-----M-----X?XX?X-------X?X---------------------------------------------------------M--X?X--f
-------------------------------------------X?X----------X?XX?X-X?X------X?X-------M-X?X----M---------------M--------M-------M-M-M------M----------M--------M------XMX----------X?XX?X------------------f
------------------------X?X---M---------M---------M-M-------------------------------X?X---------------------------------------------------M----------X?X---X?X-----M--------------M---------X?XX?X-----f
------------X?X----------M----------------X?X-------M-M---------------M-------------X?X---M----------------MMX?X--M---M-----------M---X?X---M----XMX------X?X-----------X?X-------M-M----M-----X?X-----f
m----ME-------M---ME----E---------------M--EM-M-----EEE---------EE------------------M----E--E----------E------M---EE-EE---------------E-----E-E--E-E------EE------M-------------E-----E--E-------E-----X
XXXXXXXXXXXXXXXXXXXXXXXXXXXXXXXXXXXXXXXXXXXXXXXXXXXXXXXXXXXXXXXXXXXXXXXXXXXXXXXXXXXXXXXXXXXXXXXXXXXXXXXXXXXXXXXXXXXXXXXXXXXXXXXXXXXXXXXXXXXXXXXXXXXXXXXXXXXXXXXXXXXXXXXXXXXXXXXXXXXXXXXXXXXXXXXXXXXXXXXX
