-----------------E------E-----------------E--------E-E-------------E--------------E-------------------E-----------------E----------------E--------------E------------------------------E--------E-------
---------------------------------------------------------------------------------------------------------------------------------------------------E------------------------------E---------------------
--------------------------------E---------E--------------------------------------------------------------E------------------------------------------------------------------------E---------------------
--------------------------------------------------------------------------------------------E------------------------------------------------------------------------------E--E-------------------------
--------------------------------------------------------------------------------------------------E---------------------------------------------E-------------------------------------------------------
--E-----------------------------------------------------------------------------------------------------------------------------------------------------------------------------------------------------
----------E-------------------------------E--------E------------------------E----------------------------------------------E--------------E----------------------------------------------E--------------
--------------E--------------E-----------------------------E----------E----E------------------------E-E--------------------------------------------------------------------------------------------E---v
-----------------------------------------------------------E---E---------------------------------------------------------------------------------------------------E-----------------------------------f
-----E----E-----------------------------------------------------------------------------EE---------------------------------------------------E-------E-------E-------------E---------------------------f
-----------------------------------------------------------------------E-------------------------------------------------------------------------------------------------------------------------------f
---------------------------------------------------------------E----------------------------------E-----E------------------------------------------E-----E---------------------------------------------f
----------------E-----------------------------E----------E---E--------------------------------------------E------EE---------------------E-------------------E--------E--------------------E------------f
------------------E-----------------E----------------------------------------------------------E-----------------------------------------------E-----------E------------------E--E-EE--------------E---f
m--------------E----------------------------------------------------------------------------------E------------------------------------------------------------------------EE--------------------------X
XXXXXXXXXXXXXXXXXXXXXXXXXXXXXXXXXXXXXXXXXXXXXXXXXXXXXXXXXXXXXXXXXXXXXXXXXXXXXXXXXXXXXXXXXXXXXXXXXXXXXXXXXXXXXXXXXXXXXXXXXXXXXXXXXXXXXXXXXXXXXXXXXXXXXXXXXXXXXXXXXXXXXXXXXXXXXXXXXXXXXXXXXXXXXXXXXXXXXXXX
