-M-----------------------------------------------M--------------------?--------------------------------M-?-M----------M-------------------M-M-?--?-?----M----------M---------------?-----?----M---------
------------------------------M------------------------M-------?-?-------M--------------------------M----M---------?--------M--------------?--?----?----------------?---------------------------------?-
---M-------?-----------------------------??------------?---------------------------------------------------------?--------M-----------------M--------------------?--?-----------------------------------
---------M------------------------------?----M------------------------------------------------------------M-----------------------------------?-----------------?-----------------?----------------?----
-------------------------?--M-------------------------?------------------------------------?--?------------------M-----------?----??------?-----------?--------M----------------------------------------
----------------M-----M----------------------------------------------------------------------------------------------------------------------M-------------M---M?--------M----------------M-------------
--?--M---------------?------------------------------------------------M------M--?-------------------------------------?--------M-----------------------------------------M----------------?-------------
-------------------M----------------------------M-----------?----------------------------------------------------------------?--------?-----------?M--------?----------------------M-------M---------M-v
------------?--------------------------------M----------------------------?------------------------------------------------------------------------------?---------------------------------------------f
--------M-M---------?---?--------------?--M-----M-------------M-----------------------------------------------------?--------------------------------?---------------------------------------?---------f
--------------?---M------------------------------------------------?-?------M------M-----------------------------------M-----M---------------------------------------M---------------?-----------------f
-------------M------------?-------------------------------------?----?---?----------?-----------------------M---------------?-----------------M---------------------??-------------M-------------------f
---------M------------?-------------------------------------------?----M--------------------?--------------M-M------------------------------------------------------------------------------------M----f
-----------------------------------?-?-------M---------?--M----------------------M----------------?---------------------?----------------------?-------M--?------------?---------?------------??-------f
m---??-----------------?-E--M------------M---------?---M---------?--E--E--------?----E-------------E------------------M--------------?-----M-------M----?--------?--EE-------M--------M-----E--?-------X
XXXXXXXXXXXXXXXXXXXXXXXXXXXXXXXXXXXXXXXXXXXXXXXXXXXXXXXXXXXXXXXXXXXXXXXXXXXXXXXXXXXXXXXXXXXXXXXXXXXXXXXXXXXXXXXXXXXXXXXXXXXXXXXXXXXXXXXXXXXXXXXXXXXXXXXXXXXXXXXXXXXXXXXXXXXXXXXXXXXXXXXXXXXXXXXXXXXXXXXX
