------------------------------o---------------?--------------------------------------------------------------------------------M---------------o----?---------------o------------o----------------------
----------------------------------------------------o----------o------------------M------------------------------------o--------------------------------------o-----------o-------o---------------------
---------------------------------o------o---------o------------------------------------o---o------------------------------------o-----------------------------------------------------------------------
--oo-----------------o----M--o-------------------------------------------------------------o---------------------------M----o-------------------------------------o--------o----------------------------
------------o----o----------------------o---------------o--------------o----------------------------------------------------o----o--------?-----------o-----M--------------------------oo-----o--o------
-----------------------------------?---?------o------------o-------o-----o---------o----------------------------o------o----o-----o--o----o-o-----------------------------------------------------------
----------------------------o-----------o-------o--------------------o---------------------------o-------------------------------------------------o------?------------------------o--------------------
--------------------?----o---------------------o-o-----------------------o----------------------------------------------------------------?----------?-------------M-----------------o-----------------v
---X-----------------X--------------X-------X-----X-------------------------------X--?----?----------------------------------------X------------X----------------X-----------------------X-------------f
---------?----------------X-X---------------------M---?-----------------------------------------XX---------------------------------X-----------------------?--X---------------M-----------------XX-----f
-------------X----------------X-----------------------------------------------------------?-----------------X------------------------------------------------X-------X--------?------------X-----------f
-------------X-----------------------------------------------------------------X------------------------------X---------------------------------------------------X--------------------------MX--------f
----------------X----X-----X--------------------------------X-----------------------------X-X----------------------------------------------------------X----X------------------------------------------f
--------------------------------X----------------M---------------------X---------------X---------------------------------------------------------------------------M----------------X------X-----------f
m---------------M--X---------------E-----X-----E?-------------E----------------------X------------E-X--------X-----E--------------------------------------E--------X---------X---------E--X--------X---X
X----XX---XX---XXX----XX---X-X-------XX---XXX-X----XX-------------X--XXX----X--X-X-X------------X----X---X--X----XX------XX-XXX--------X----X-X-X--X------XX---X--------XX------X------XX--X---X-X-XX--X
