--------------------------------------------------------------------------------------------------------------------------------------------------------------------------------------------------------
--------------------------------------------------------------------------------------------------------------------------------------------------------------------------------------------------------
--------------------------------------------------------------------------------------------------------------------------------------------------------------------------------------------------------
--------------------------------------------------------------------------------------------------------------------------------------------------------------------------------------------------------
--------------------------------------------------------------------------------------------------------------------------------------------------------------------------------------------------------
--------o----------------------------o------------------------------o-----------------------------------------------------------------------------------------------------------------------------------
--------------------------------------------------------------------------------------------------------------------------------------------------------------------------------------------------------
-------o----------------------------------------------------------------------------------------------------------------------o--------------------------o---------------------------------------------v
---X?X-M---------M---------------X?X-------------------X?X--X?X--------------------X?X---M-----------------------X?X---------X?X--------------------------M-------X?X------X?X-------------X?X---------f
-MX?XX?X----M--M--X?X-----------M---M-------MM--------M---------------------X?X-------M---------X?X-----M-------X?X------MX?X------X?XX----------------------------X?X------------------X?X------------f
--?X---X?X------M----X?X?X-------------M------MMX?X?XX?X----------------M---------X?X--X?X----------M-X?X-M-----M--------X?X-------X?X-------------------------------------------M-------------M--X?X--f
-----------------M--X?X--------------------X?X--X?X?XX?XXMXX?X----------X?X-------M-X?X-------------X?X?X--M--------MX?X----M-M-M------M----------M---------------X?X----M--------X?X-X?X--------XMX-X?f
-M----M-----M-----------------M-M--------X?X?X----M-X?X---X?X---------X?X---------M-X?X---------M------------X?X----------X?X-------------M----------X?X---X?X-----M-XMX-M--------M---------X?X--------f
-------M----M------------X?X-------X?X----X?X---M--X?X-----------X?X------------M---X?X---M----------------M----------M-----------M---X?X---M----X?X------X?X-------------------X?XMM----M-----X?X-X?X-f
m-----E------MM-ME-E----E---------------M-----M----ME-E--E------E----M--M--------E--ME---EE-----E---M--E------M---E--E--------------M-E----EE-E--E-----E---EE--E--M------------M------EE---------E-----X
XXXXXXXXXXXXXXXXXXXXXXXXXXXXXXXXXXXXXXXXXXXXXXXXXXXXXXXXXXXXXXXXXXXXXXXXXXXXXXXXXXXXXXXXXXXXXXXXXXXXXXXXXXXXXXXXXXXXXXXXXXXXXXXXXXXXXXXXXXXXXXXXXXXXXXXXXXXXXXXXXXXXXXXXXXXXXXXXXXXXXXXXXXXXXXXXXXXXXXXX
