---------------------------------------o------------o------------------------------------o--------------------------------------------------------------------------------------------------------------
--------------------------------------------------------------------------------------------------------------------------------------------------------------------------------------------------------
------------------------------------------------------o-------------------------------------------------------------------------------------------------------------------------------------o-----------
--------------o--------------------------------------------------------------o--------------------------------------------------------------------------------------------------------------------------
-------------------------------o-------------------------------------------------------------------------------------------------------------------------------------------o----------------------------
----------------------------------o---------------------------------------------------------------------------------------------------------------------------------------------------------------------
--------------------o-----------------------------------o-------------o---------------------------o---------------------------------------------------------------------------------o-------------------
-----------------------------------------------------------------------------------------o------------------------------------------------------------------o-------------------o----------------------v
----------------------------------------------------------------M-----------------------------------------------------------------------------------------------M--------------------------------------f
-----------------------------------------------------------------M-----------------------------------------------X?X--------M--------------------------------------------------------------------------f
-----------------------------------------------X?X------------------------------------------X?X-----------X?X-----------------------X?X-----------------------------------------M----------------------f
------------------------------------X?X-----------------------X?X----------------------------------------M--X?X-----------X?X---------------------X?X--------------X?X----------------------M----------f
--------------------------------------------M--------M-----------------------------M---------------------------------------------------M---------------------------------------------------------------f
---------------------------------------------------------------------------------------------------------------------------------------------------------------------------M---------------------------f
m----------------------------------------------------------------------------------------------------------------------E-------------------------------------------------------------------------------X
XXXXXXXXXXXXXXXXXXXXXXXXXXXXXXXXXXXXXXXXXXXXXXXXXXXXXXXXXXXXXXXXXXXXXXXXXXXXXXXXXXXXXXXXXXXXXXXXXXXXXXXXXXXXXXXXXXXXXXXXXXXXXXXXXXXXXXXXXXXXXXXXXXXXXXXXXXXXXXXXXXXXXXXXXXXXXXXXXXXXXXXXXXXXXXXXXXXXXXXX
