----------o--------o------------------------------------------------------------------------------------------------------------------------------------------------o-----------------------------------
-----------------------------------------------------o--------------------------------------------------------------------------------------------------------------------------------------------------
--------------------------------------------------------------------------------------------------------------------------------------------------------------------------------------------------------
----------------------------------------------------------------------------------------------------------o---------------------------------------------------------------------------------------------
--------------------------------------------------o-----------------------------------------------------------------------------------------------------------------------------------------------------
--------------------------o-----------------------------------------------------------------------------------------------------------------------------------------------------------------------------
--------------------------------------------------------------------------------------o-----------------------------------------------------------------------------------------------------------------
----------------------------------------------------------------------------------------------------------------o--------------------------------------------------------------------------------------v
----------------------------------X?X----------------------------------------------------------------------X?X---------------------------------------------------X?X---------M-X?X---------------------f
-M----------X?X----------------------------------------------------------X?X------------------------------------------------X?X-----------------------------------M------------------------------------f
---------------------------X?X------------M------------------------------------------------------X?X----------------------------------------------------------------------------X?X--------------------f
------------------------------X?X--------------------------------M--------------------------------------------------------X?X------------------------------------------------M----X?X------------------f
----M---------------------------------------------------------------------X?X----------M---------M---------------------------------------------X?X--M-----------------------X?X-M----------------------f
--------X?X------M---------------------------------------------------------------------------------------------------------------------M---------------------------------------M-------M---------M-----f
m-------------X?X----M--------------------M------X?X--M---------------------------------E-----------------------------------E---------------------M-------------------E---------------------E----------X
XXXXXXXXXXXXXXXXXXXXXXXXXXXXXXXXXXXXXXXXXXXXXXXXXXXXXXXXXXXXXXXXXXXXXXXXXXXXXXXXXXXXXXXXXXXXXXXXXXXXXXXXXXXXXXXXXXXXXXXXXXXXXXXXXXXXXXXXXXXXXXXXXXXXXXXXXXXXXXXXXXXXXXXXXXXXXXXXXXXXXXXXXXXXXXXXXXXXXXXX
