--M--------M-------M------E---------------------E-------------M------------------------------M-E------E-----------M-----?---------E----?ME-------?---------------------?M-------------------------------
-------------------E-?-------------------------------------M------------------------------------------------?--------------------------?---------------------------?--------E---------------------------
-----------------E--------M---------------------E------------------------------------------------------E-------------------------M----------------------------------------------?-------------------?---
-------------------------------------------------------------------------------E------------------?-----------M--------------------------------------------------------E--------------------------------
--------------------------------------------------------?---?--------------------------------------E-----M----------------------------------------------------------------------------------------E-----
-------------------------?-----------E--------------------------------------------------E-------E---?--------------------------------------------------------------------------------------M------------
-----------E------------E-----------?---M---------------------------E------------------------------------------------------------E-----?--------M---------------M---------------------------------------
------------------------------M--M----?-----------------M----------------------------------------------------------------------------------------------E-----------------------------------------------v
--------------------------------------------------------------------------------------------------------------------------------------------------------------------M----------------------------------f
-M----------------------------?----------------------------------------------?-------------------M-------------------E---------------------------------------------------------?-----------?-----------f
-------?--------------------------------------------------------------E-------------------------------------------------------------------------------------------------------?-?----------------------f
----------------------------------------------------------?---------------------------------------------------M----------------------------------------------------E-----------------------------------f
--M--------------M--------------?----------------------------------------------------------------------------------------------------------------------------------------------E------------------?----f
-------------------------------------------E-----------------------------------------------------------------------------------?--------------------------------------------?--------------------------f
m--------E-------------------------?-?-E?---?-------------------------------------------------------------------------------------?---------------------------------------------M----------?------E----X
XXXXXXXXXXXXXXXXXXXXXXXXXXXXXXXXXXXXXXXXXXXXXXXXXXXXXXXXXXXXXXXXXXXXXXXXXXXXXXXXXXXXXXXXXXXXXXXXXXXXXXXXXXXXXXXXXXXXXXXXXXXXXXXXXXXXXXXXXXXXXXXXXXXXXXXXXXXXXXXXXXXXXXXXXXXXXXXXXXXXXXXXXXXXXXXXXXXXXXXX
