--------E------------------------------------------E--------------E-----------------------------------------------------------------------------------E-------------------------------------------------
--------------------------------------------------------------------------------------------------------------------------------------------------------------------------------------------------------
---------------------------------------------------------------------------------------E----------------------------------------------------------------------------------------------------------------
----------------------------------------------------------------------------------------E---------------------------------------------------------------------------------------------------------------
-----------------------------------------------------------------------------------------E------------------------------------------------------E-------------------------------------------------------
-----------------------------E--------------E-----------------------------------------------------------------------------------------------E-----------------------------------------------------E-----
----------------------E---------------------------------------E-------------------------E-------------------------------------------------------------------------E-------------------------------------
-----------------E------------------------------E-----------------------------------------------------------------------------------------------------------------------E------------------------------v
-------------------------------------------E------------------------------------------------------------------------------------------E-------------------------------------------------------E--------f
----------------------------------------------------------------------------------------------------------------------------------------------------------------------------------E--------------------f
---------------------------------------------------------------------------------------------------------------------------E---------------------------------------------------------------------------f
--------------------E-----------------------------------------------------------E------------------------------------------------E--------------------------------------E------------------------------f
----------------E--------------------------------------------------------------------------------------------------------------------------------------------------------------------------------------f
---------------------------------E--------------------------------------------------------------------------------------------------------------------------------------------------------E---------E--f
m-------------------------------------------------------------------------------------E-----------------------E------------------------------------------------------------E---------------E-----------X
XXXXXXXXXXXXXXXXXXXXXXXXXXXXXXXXXXXXXXXXXXXXXXXXXXXXXXXXXXXXXXXXXXXXXXXXXXXXXXXXXXXXXXXXXXXXXXXXXXXXXXXXXXXXXXXXXXXXXXXXXXXXXXXXXXXXXXXXXXXXXXXXXXXXXXXXXXXXXXXXXXXXXXXXXXXXXXXXXXXXXXXXXXXXXXXXXXXXXXXX
