----o-----------------------------------------------------------------------------o------------------------------------------------------------------------o--------------------------------------------
----------------------------------------------------------------------------------------------------------------------------------------------------------------------o---------------------------------
--------o------------------------------------------------------------------------o------------------------------------------o--o-----o------------------------------------------------o-----------------
--------------------------------------------o-------------------------------------------------------------------------o---------------------------------------------------------------------------------
----------------------------------------------------------------------------------------------------o-----o---------------------------------------------------------------------------------------------
----------------------------o-----------------------------------------------------------------------o-------------------------------------------------o-------------------------------------------------
---------------------------------------------------------------------------------------------------------------o----------------o-----------------------------------------------------------------------
-----o--------------------------------------------------------------------------------------o----------------------------------------------------------------------------------------------------------v
-----------------------------------------------------------------------------M-------X?X--X?XM-------M-------------------------------------------------------------------------------------------------f
-----------------X?X-----------------------------------------MX?X--------------------------------------------------------X?X----------X?X--------------------------------------------------------------f
------M--------------------X?X------------------------------------X?X--------------------------------------------------M---M----X?X--------------------------------------------------------------------f
-------------------------------------------------------------------------------------------------------------------------------X?XM--------X?X------------X?X------------------------X?X---------------f
-------------------------M---------------------------------------------------------------------------------X?X----------------------X?X----------------------------------------------------------------f
----------------------X?X--------------------X?X----------------X?X-------------------------X?X------------------------X?X------------X?X-----------------------------------------M--------------------f
m----E-M------EE-----------------------E--------------------M----------------------E------M-----M--------------------MME-----------------M-------------------------------------------------------------X
XXXXXXXXXXXXXXXXXXXXXXXXXXXXXXXXXXXXXXXXXXXXXXXXXXXXXXXXXXXXXXXXXXXXXXXXXXXXXXXXXXXXXXXXXXXXXXXXXXXXXXXXXXXXXXXXXXXXXXXXXXXXXXXXXXXXXXXXXXXXXXXXXXXXXXXXXXXXXXXXXXXXXXXXXXXXXXXXXXXXXXXXXXXXXXXXXXXXXXXX
