-----E-----M--------?-------------------------------------?------------------------------E-------------------------------------------------------?---M--M---E-------------------------M--------?--------
---------M-----------------------------------------------------------------------------------M--------------------------------------------M-------------------?-----------------------------------------
-------M----------------------------------------------------------------------------------------------------?----------------------------------?--------------------------------------------------------
----------------------------------------------------------------E--------------------------E-E--------------------?-------------------------------------------------------------------------------------
---------------------------?-----------------------------------------------------------------------E------------------------------E----------------------E--------------------?-------?--------?--------
---------------------------------------------?--------------------------------------------------------------------------------------------------------------?-----E-------------------------------------
----------------E-------------------E----------------E-----------M----------------------------------------------E-----------------------------------------------E---------------------------------------
----E------------------------------------?----------M-----------M-?--------------------------------------------E------------------------------------------------------M--------------------------------v
------?------------------------?-------?------E------------------------------------E-------------------------------------------------------------------------------------E--------------------E------?-f
------------------------------------------------------------M-----------?-----------------------------------E--------------------------------------------------E---------------------------------------f
---------------------?-----?E---------------------------E-----------------------------E-----------------------------------------------------------------------------------M-----------M----?-----------f
--------?---?---------------------------------------------------M-----------------------------------------------------------------------E----------?-----------------------E---------------------------f
-----------------------E--------------------------M---------------M---?------------------M-----------M----------M----------------------------------------------------------------------------?---------f
------------------------------------------------------------------?------M---------------E---------------------------------------------------------M------------------------?-------------------------Ef
m--------------------------?---?--------------------------------M--------M-------------------M-----------------------EE-----------------------------M---M------------------------------M---------------X
XXXXXXXXXXXXXXXXXXXXXXXXXXXXXXXXXXXXXXXXXXXXXXXXXXXXXXXXXXXXXXXXXXXXXXXXXXXXXXXXXXXXXXXXXXXXXXXXXXXXXXXXXXXXXXXXXXXXXXXXXXXXXXXXXXXXXXXXXXXXXXXXXXXXXXXXXXXXXXXXXXXXXXXXXXXXXXXXXXXXXXXXXXXXXXXXXXXXXXXX
