---------------------------E----------------------E-------?-----------E---?-------------?M------------E---------?---M------M----M-------------------------------E--E--------?----?-------------M------?-
------------------------------------------------------------------------------------------------------------------------------------M------?------------------------------------------------------------
-------------------------------------E------------------------------------------------M---------------------------------------------------------------------------M---------------?--M------------------
----------------------?--------------------------------------------------E-------------------------------?----------------------------------------------------------------------------------------------
----------------------------------------E-?----------------------------------------------------------------------------------------------E--------------------------------------------------------------
----M-----------------E-----M--------------M----------E--?-------------------------------?---------------------------------------------------------------------------------------------?----------------
-----------------------------------?--M---------------------------------------?--------------------------------------------------------------------------------------------------------E----------------
--------------------E----?------------------------------------------E-----------------------------------------EE------------------------------?-----------M-------------------------------------------Ev
----------------------------------------------------------------------------------------------------M-----------------E---------E------------------------------------------------------M--------?------f
----M---------------------------------------------M------------------------------------?-------------?------------------------------------------E-------------------------------------------------E----f
---------------------------------------E----------M---------------M------------------------------------E------------------------------------------------------M---M----------------E-------------------f
------------------------------------------------------------------E--?---------------?-------------?----------------------------------------------------E--------------?-------------------------------f
--E----------------------------------------------?------------------M---------------------------------?--------------------------------------?-------------------------?--E----------------------------f
--------?-----------------------------------------?--------------------------------------------------------------------------M-----------------M-------------------------------------------------------f
m----------------------------------------------------------------------------------------------E-----------------------------E----------M----E-M-----E-------------------------------------------------X
XXXXXXXXXXXXXXXXXXXXXXXXXXXXXXXXXXXXXXXXXXXXXXXXXXXXXXXXXXXXXXXXXXXXXXXXXXXXXXXXXXXXXXXXXXXXXXXXXXXXXXXXXXXXXXXXXXXXXXXXXXXXXXXXXXXXXXXXXXXXXXXXXXXXXXXXXXXXXXXXXXXXXXXXXXXXXXXXXXXXXXXXXXXXXXXXXXXXXXXX
