-----------------------E-----------------------------------M------------------E---?----------------------------------------------------------------------------------E----------------------------E-----
--------------------------------------------------------------------------------------------------------------------------------------?----------------------------------------------------------M------
-----------E------------------E--------M------------------------M----------------M----E---------------------------------------M---------------------------------------------------------------------E---
---M-----------------------M-----M-----------------------------------------------------------------E--------------------M---------M------------------?------------------------------------------E-------
-----------------------------M-----------------------------------------------------------------------------------------------------------------E--------------------------------------------------------
----------------------------------------------------------?------------E-------------?----------------------------------E-------------------------------E---------?-------------------------------------
------------------?---?--------------------------------------------M--M-----------------------------------M------------?-?--------------------------------------------------------E---------------------
---------------------E-------------------E-----------------------------------------------------------------M-----------------------------------------------------------?-------EE----E---?----------M--v
-------------------------------?--------?---------------------------------------------------------------------------?-------------------------------------M--------------------------------------------f
--------------------------?------------------------------M----------------------------------------------------------M--------------------------------------------E-------------------------------------f
------------E----------?-------------E-----------------E----------------------------------------------------------E---M----------------------------------------------?---------------------------------f
-------------------------------?--M---M---------------------------------------------------------M-E----------------------------------------------------------------------------------------------------f
------------------------------------------------------------?-------------------------------------------------E-------------------------------------EM------------E-------E----------------------------f
-----------?-M--------------------------?---M------------------?-----------------------E-------------------------------M--------?-------------?-----------------------------?--------------------------f
m------------------------------?---------------------------------------------------------------------------------------?-------------?-------E---M----------------------------?-?------?---------------X
XXXXXXXXXXXXXXXXXXXXXXXXXXXXXXXXXXXXXXXXXXXXXXXXXXXXXXXXXXXXXXXXXXXXXXXXXXXXXXXXXXXXXXXXXXXXXXXXXXXXXXXXXXXXXXXXXXXXXXXXXXXXXXXXXXXXXXXXXXXXXXXXXXXXXXXXXXXXXXXXXXXXXXXXXXXXXXXXXXXXXXXXXXXXXXXXXXXXXXXX
