-------------M--------o-------------------?--------------------o----------------------------------------o-------------------------------------M------------M-------o---o--o----------o-?----------o-----
------------------------------------------o-----------------o-----o-----o--------o--o-----------------------------------------------------------------------o------------o--------o----M----------------
--o----------o-----------------------o-o-----------------o------------------------------------------o-------o----------------------------------------------Mo----------------------------o-o------------
--------------------------------o-----------------------------------------o-------------------------------o-----o----o-------M-------------------------------------------------------o------------------
--o---------------o-------------------------o--------------------------o----------------------------o?-o-----o-o-------------------------------oo--------------------o--o----------------o--------------
------------------------------------------o-----?------oo---------------------------------o------------o------------------------------------------------o------------------o----------------------------
----------------?-----------------------------o-----------------------------------------------------------------------------------------------?o--------------o----------o-----?------o-----------------
---------------------------------------------------------------------------o-?-----o--------------------------------------o--o--------------------------------o-------------o--------------o--o----o---v
-X----------------X----------------------------------------X---X-X----X-------------------------X--X-------------------X---------X--------------------------------X-----X-------X----X---XX------------f
-----X----------------------------?---------------------M----X--------------------------------------------------------X---X-------------------X-----M-----------------?--------------------------?-----f
---X---X------X--------------------------------X-------------------------------------XX----------------------------?------------------X------------------------------------X-------------------------X-f
-----------------------X---------X-------X-------X-----X--X-----?-----M-------X--------------------------------------X---------------------XX-------?----XX-X----X-----------------X-----------X---X---f
----------X-------X--------------------X------------------------M---------------------------------------X------------------------?------------------------------------------------------------X--------f
----------------------------------------X-----------------------------------------------------X------------------XX---X------X-----------M------------------X------------------------------------------f
m---X---------------------E-X--E-------E-------------E----M--------------------------------------X-EX--------------------M------X---X--E------------------X-X--------XE--M---------------------E-----XXX
XX--X----X-X-X----X-X----XX------------XX-------------X--X-X--XXX-X--------XXX------XX-----X-XXX----X-X----XXX-X-----X-X----X-X--------XX-X---X-----------X----X-------X--XXX--X-X--XXX------XX-XX--X--X
