---------?-o----------------------------------?------------------?----o?-o-----o----------o-M-----o----------------------------M----------------------------------------------------M--------o---M------
-?--o------------------------------------------------------------------------------------o----------------o---o-----M---------o-----------------------------------------------------------o-------------
-o--------------------------o---------------------------------------------------------------------------------------o-o--------------------------------o------------------------------o-----------------
-----------------o------o-----------------------------------oo-----o----------o-----------o----------o------------------------o------?------------------------------------------------o-----------------
---o------------------------o--------------------------------------------o-----------o---o-----------------------------------o-----------------------------------------o--------------------------------
------o------o--------------------------------------------------------------o-----------------------------M---------------o-----o-----------------------------------------------o------o-----o----o-----
----------------------o------------------------------o----------?-----------------------------o-------------------?------o----------?---------------o---------------------------------------------------
-------o-------------------------?-----------M-------------------o------?-M----------o-----------------o--------------o--o--------------------o---?----------------------------------------------------v
----X----X--------------------------------------M-M---------------X-------------X-------------X-------------X---------------X--------X--------------------M--------------------------------------------f
-----------------------X--------------X---M-------X------------------------------------------X--------X-------------X----------------X---X-------------------------------X-----X----------X------------f
-----------------------------------------------X----------X------------------------X--------X---------------X---------------X------X----------------M--?------------------X----------------------------f
---------M--------------X-----------X-----------------------------?------------M----------------------------X-----------------------X-------------------------------------------------------X----X-----f
------X-----------------------------------------X-M--------------------XX-----MX------------X-------------------------------------------X------X-------X----------M------------------X--X------------X-f
---------------------------X----------X---------X-----------------------------------------------X-X----------------------XX-----------------------------------X------------M---------------------------f
m---?-----X----------------------------E---------E---M---E-E-----------M-----------------E-----X---------------M--------X---------------------------X--------------------------------------------E-----X
X----XXX-X-------X-X--------X----XX-------X--X-----X-XX--X---X-------X-XX-------X------X---X------XX-X------X----X---X----X--X-X--------XX----------X---X-XX-----X-X--------X-X---X-X-XX-----XX-----XX-X
