----o--------o---o-----------------------------------------------------------------------o--------------------------------------------------------------------------------------------------------o-----
-----------------------------------------------------------------------------------------------------o-----------------------------------------------------o--------------------------------------------
---------------------------------------------------------------------------o----------------------------------------------------------------------------------------------------------------------------
--o-----------------------------o----------------------------o------------------------------------------------------------------------------------------------------------------------------------------
-----------------------------------------------------------------------------------------------------------------------------------o-------------------------o-----o------o-----------------------------
-----------------------------------------------o--------o-----------------------------------------------------o-----------------------------------------------------------------------------------------
------------------------------------------------------------------------------------------------------------o-------------------------------------------------------------------------------------------
-------------------------------------------------------------------------------------------------------------------------------------------------------------------------------------------------o-----v
----------------------------------------------------M----------------------------------------X?X-------------------------------------------------------------------------------------------------------f
-----------------------------------------------M------------------------------X?X-----X?X--------------------------------------------------------------------------------------------------------------f
-----------------------------------------------M----------------------------------M---------------------X?X--M----------------X?X----------------------------------------------------------------------f
----M------------X?X------------------------------M---------------------------------------------------------------------------------------X?X--------------X?X--------------------------------------M--f
------------------M------------------M--------------------------------------M----------------------------------X?X---------------------------------------------------------X?X---------M---------------f
---------X?X---------X?X-----X?X--------------------------------------------------------MMX?X-------------------M--------------------------------------------------------------------------------------f
m--------------------------------------------------------E---------E---M--------------------------M-----M----------------------------------------------------------------------------------------------X
XXXXXXXXXXXXXXXXXXXXXXXXXXXXXXXXXXXXXXXXXXXXXXXXXXXXXXXXXXXXXXXXXXXXXXXXXXXXXXXXXXXXXXXXXXXXXXXXXXXXXXXXXXXXXXXXXXXXXXXXXXXXXXXXXXXXXXXXXXXXXXXXXXXXXXXXXXXXXXXXXXXXXXXXXXXXXXXXXXXXXXXXXXXXXXXXXXXXXXXX
