---o-------------------------------------------------------------------------------------------------------------o--------------------------------------------------------------------------------------
-----------------------------------------------------------------------------------------------------------------------------------o---------------------------------------o----------------------------
------------------------------------------------------------------------------------------------------------------------------------------------------------------------------------------------o-------
------------------------------------------------------------------------------------------------------------o-------------------------------------------------------------------------------------------
--------------------------------------------------------------------------------------------------------------------------------------------------------------------------------------------------------
--------------------------------------------------------------------------------------------------------------------------------------------------------------------------------------------------------
----------------------------------------------------------------------------o-------------------------------------------------------------------------------------------------o--------------------o----
-----o-------------------------------------------------------------------------------------------------------------------------------------------------------------------------------------------------v
-------------------M----------------------------------------------------------------------------M----------------------------------------------------------------------------------------------------X?f
----------------------M-----------------X?X-------------------X?X------------------------------------X?X-------------M------------X?X----------------------------------------------M-------------------f
-------------X?X-------------------------------------------------------------------------------M-------------------------------------------------------------------------------------------------------f
------------------------------------X?X-------------------------------------------------------X?XM-------X?X-------------------------------------------------------------------------------------------f
-------------------------------------------------------------------------------------------------M-X?X------------------------------X?X-------------------------------------------------X?X------------f
-----------------------------------------------------------------------------------M------------M------------------------------------X?X---------------------------------------------------------------f
m----------------------E-------------------M----------------------------------------------------M---------M---------E------------------------------------------------------------------------------M---X
XXXXXXXXXXXXXXXXXXXXXXXXXXXXXXXXXXXXXXXXXXXXXXXXXXXXXXXXXXXXXXXXXXXXXXXXXXXXXXXXXXXXXXXXXXXXXXXXXXXXXXXXXXXXXXXXXXXXXXXXXXXXXXXXXXXXXXXXXXXXXXXXXXXXXXXXXXXXXXXXXXXXXXXXXXXXXXXXXXXXXXXXXXXXXXXXXXXXXXXX
