---------------------------------------o-o---------------------------------------------------------o----------------------------------------------------------------------------------------------------
------------------------------------------------------------------------------------------------------------------o-------------------------------------------------------------------------------------
---------------------------------------------o----o----------------------------------o----------------o------------------------------------------------------------------------------------------o------
---------------------------------o----------------------------------------------------------------------------------------------------------------------------------------------------------------------
--------------------------------------------------------------------o---------------------o----------------------------------------o--------------------------------------------------o-----------------
--------------------------------------------------------------------------------------------------------------------------------------------------------o-----------------------------------------------
---------------------------o----------------------------------------o-----------------------------------------------------------------------------------------------------------------------------------
----------------------------------------------------------------------------------------------------------------o---o----------------------------o-----------------------------------------------------v
---M----------------------------------------------------------------------------X?X--X?X---------------------------------------------------------------------------X?X---------M-----------------------f
---------------------------------X?X------------------------------------------------------------X?X-----X?X--------------------------------------------------------------------------------------------f
-----------------------------------------------------------------------------------------------------------M-------X?X------X?X---------------------------------------------------------X?X------------f
-----------------------X?X--------------------------------X?X-----------------------------------------------------------------------------------------------------------------X?X----------------------f
---------------------------------------------M-------------M-------M-----------------------------------------------X?X--------------------------------------------------------------------M------------f
--------------------------------------------------------M-----------------------------------------------------------------------------------------M-------------------------------X?X------------------f
m------------------M----------------------------------------------------------------------------------------------E-------------------------------------------------E-------------------------E--------X
XXXXXXXXXXXXXXXXXXXXXXXXXXXXXXXXXXXXXXXXXXXXXXXXXXXXXXXXXXXXXXXXXXXXXXXXXXXXXXXXXXXXXXXXXXXXXXXXXXXXXXXXXXXXXXXXXXXXXXXXXXXXXXXXXXXXXXXXXXXXXXXXXXXXXXXXXXXXXXXXXXXXXXXXXXXXXXXXXXXXXXXXXXXXXXXXXXXXXXXX
