-------o-------------------------------------------------------------------------------------------------------------o---------------------------------------------------------------------------o------
--------------------o---o------------------------------------------------------------------------------o------------------------------------------------------------------------------------------------
---------------------------------------------o-----o---o------------------------------------------------------------------------------------------------------------------------------------------------
--------------------------------------------------------------------------------------------------------------------------------------------------------------------------------------------------------
----------------------------------------------------------------o-----------------------------------------------------------------------------------------------------------------------------oo--------
----------------------------o--------------o-----------o---------------------------------------------------------o-----------------------------------------------------------------------------o--------
--------o---------------------------------------------------------------------------------------------------------------------------------------------o-------------------------------------------------
----------------------------------------------------------------------o---------------------------------------------------------------------------------------------------------------------------o----v
-------------------------------------------------------------------------------------------------------------M-------------------------------------------------X?X--------M--------M-------------------f
--------------M------------X?X----------X?X--------------M-------------------------X?X------------M-------------------------------------------------------------X?X------------------------------------f
------------------------------------M--------------------------X?X--------------------------------------X?X-------------------------------------------X?X----------------------------------------------f
---------------------------------------------M------------------------------------------------------M--------------------------------------------------------------------------------------------------f
------------------------------------------------------------------------------------------------------X?X---------------------M------------------------------------------------------------------------f
--------------X?X-----X?X-----------------------------X?X-X?X-------------------------------------------X?X------------------------------------X?X------------------------------------X?X--------------f
m----------------E---------------M------------------------E-------------------E------------------------------------X?X-------------------------X?X------------------------X?X---E----------------------X
XXXXXXXXXXXXXXXXXXXXXXXXXXXXXXXXXXXXXXXXXXXXXXXXXXXXXXXXXXXXXXXXXXXXXXXXXXXXXXXXXXXXXXXXXXXXXXXXXXXXXXXXXXXXXXXXXXXXXXXXXXXXXXXXXXXXXXXXXXXXXXXXXXXXXXXXXXXXXXXXXXXXXXXXXXXXXXXXXXXXXXXXXXXXXXXXXXXXXXXX
