-M----------------------------M------------------------?-------M---M---------------------------?-E----E------------M--M---------------M?-------------E-----------------------------------------?---E----
-----------------------------M--M-------------------------------------------------------------------------------------E---------M---?-------------------------------------------------------------------
--------------------------------------------------E-------------------------------------------------------M-------------M----------------------M------------------------------------------------E-------
------------------------?-----------------?-----------------------------------E--------------M-----------------------------------M--------------------------------------------?-------------------------
-------------------------------M----M-------------------?-----?-E------------------M----------E---------------------------?---------------------------------------------------E-------------------------
--------------------?--------------------------------M-------------------------------------------------E----------------------E-------------------------------------------------------E-----------------
------------------------------------------------?-------------------M-------------?-----M----------------------------------------------------------------------------------------------------?----------
---------------------------------------------------M----------------------------------------------------------------M-------------------------------------E---M----------------------------------------v
------?--------------------E------------------------------------------------------M------------------------------------------------M------------------------------------------------------------------Mf
----------------------------------M---------E----?---------------E--------------------------------------------------------------------------------------------------------------------?----------------f
---??------------------------?---------------------------------E--E---------------------M-------------------------------------E--------------------------------------------------E-------------?-------f
---------?------------------------------------------------------------------------------------------E-------------------------------------?-------------?--M-------------------------------------------f
----E---------------------------------------------------------------------------------------------------------?------------------------------------?-----------------------M---------------------------f
-----------M-------------------------------------?-------------------------------------------------------------M------------------?------------------M-----------------EEE-----------------------------f
m-------------------------------------------------------------EEE--------------------M----------------------E-------------------E----------------------------------------------------------------M----EX
XXXXXXXXXXXXXXXXXXXXXXXXXXXXXXXXXXXXXXXXXXXXXXXXXXXXXXXXXXXXXXXXXXXXXXXXXXXXXXXXXXXXXXXXXXXXXXXXXXXXXXXXXXXXXXXXXXXXXXXXXXXXXXXXXXXXXXXXXXXXXXXXXXXXXXXXXXXXXXXXXXXXXXXXXXXXXXXXXXXXXXXXXXXXXXXXXXXXXXXX
