--------E----------------------------------------E------------------------------------E-----------------------------------------------------------------------------------------------------------------
------------------------E-----------E---------------E-------------E-----------E-------------------------------------------------------------------------------------------------------------------------
----------E-------------------------------------E---------------------------------E----------------E-------------------------------------------------------------------------------------E--------------
------------------------------------------------------------------------------------------E-------------------------------------------------------------------------------------------------------------
--------------------------------------------------------------------------------------------------------------------------E------------------E---------------E------------------------------------------
--------------------------------------------------------------------------------------------------------------------------------------------------------------------------------------------------------
---------E------------------------------------------E--------------------------------------------------------------------------------------------------------------E------------------------------------
--------------------------------------------E-----------------------------------------------------E--------------------------------------E------------------E---------------------------E-----------E--v
--------E--------------------------------------------------------------------------------------------------------------------------------------------E-------------------------------------------------f
--------------------------------------------------E----E---------------------------------------------------------------------------------------------------------------------E-------------------------f
----------------------------------------------------------------------E-------------------------------------------------------------------------E------------------------------------------------------f
-------------------------------------------------------------------------------------------------------------------------------------------------------------------------------------------------------f
-----------------------------------------------------------E--------------------------------------------------------------------------------------------------------------E----------------------------f
--------------------------------------------------------------------------------E----------------------------------------------------------------------------------------------------------------------f
m------------------------------E-------------------------------------------------------------------------------------------------------------E---------------------------------------------------------X
XXXXXXXXXXXXXXXXXXXXXXXXXXXXXXXXXXXXXXXXXXXXXXXXXXXXXXXXXXXXXXXXXXXXXXXXXXXXXXXXXXXXXXXXXXXXXXXXXXXXXXXXXXXXXXXXXXXXXXXXXXXXXXXXXXXXXXXXXXXXXXXXXXXXXXXXXXXXXXXXXXXXXXXXXXXXXXXXXXXXXXXXXXXXXXXXXXXXXXXX
