--------------------------------------------------------------------------------------------------------------------------------------------------------------------------------------------------------
--------------------------------------------------------------------------------------------------------------------------------------------------------------------------------------------------------
--------------------------------------------------------------------------------------------------------------------------------------------------------------------------------------------------------
--------------------------------------------------------------------------------------------------------------------------------------------------------------------------------------------------------
--------------------------------------------------------------------------------------------------------------------------------------------------------------------------------------------------------
--------o----------------------------o------------------------------o-----------------------------------------------------------------------------------------------------------------------------------
--------------------------------------------------------------------------------------------------------------------------------------------------------------------------------------------------------
-------o----------------------------------------------------------------------------------------------------------------------o--------------------------o---------------------------------------------v
---X?X-M-------------------------X?X---------X?X----M--X?X-------------------------X?X--------------X?X----------X?X----M--------------------------------------------------X?X-------------X?X---------f
-MM----M----M-X?X---------------------------X?X----------------------X?X?X------------------------------M---MMM--M--------X?X-------X?X-------------------M------M-X?X----M----X?X---------------------f
--?X--X?X--------MM----X?X------------------------X?X---------X?X--M----X?X--X?X-M----MX?X-----X?X-M---------X?X----X?X--X?X-------X?X---X?X-------X?X---------------M---X?X?X----------X?X------------f
---X?XM---------M-------------X?X-----------X?X--M------X?X------X?X--------------M------------X?X------------------X?X--X?X----M--X?X--------------------M---M----------------------------------X?X---f
---M-----X?X------------------M------X?X----------M-M--X?X--MX?X---M----------M-----X?X?X----------------M--------X?X------------X?X---------M----X?XX?X---M------X?X-----------------------XMXM---X?X-f
----------------M--------X?X---------------------------------------------MX?X-M-----X?XM--------------M----M-------M-----------M--M----MX?X-M---MX?X------X?X---------------------------------------X?-f
m-E--EM-ME---M--E-E-------E---E------------E--M--E--E-E--E----E-E-E---------E-------E--M-E------E--E---E----E-M-ME-----M-E------MM----E----EE-------MM--M--M----M-M-E-----MEM-----------------E-------EX
XXXXXXXXXXXXXXXXXXXXXXXXXXXXXXXXXXXXXXXXXXXXXXXXXXXXXXXXXXXXXXXXXXXXXXXXXXXXXXXXXXXXXXXXXXXXXXXXXXXXXXXXXXXXXXXXXXXXXXXXXXXXXXXXXXXXXXXXXXXXXXXXXXXXXXXXXXXXXXXXXXXXXXXXXXXXXXXXXXXXXXXXXXXXXXXXXXXXXXXX
