------------------------------o---------------?--------------------------------------------------------------------------------M---------------o--------------------o------------o----------------------
---------------------------------------------------------------o-------------------------------------------------------o--------------------------------------o-------------------o---------------------
---------------------------------o------o------------o--------------------------------------------------------------------------o-------------------------------------o-------------------o-------------
--o-------------------------------------------------------------------------------------------------------------------------o-------------------------------------o--------o--------------M-------------
------------o---------------------------o---------------o-------------------o---------------o-------------------------------o----o--------?-----------o-----M----o----------------------o-----o--o------
-----------------------------------?---?o--------------------------------o---------o--------------------o-------o-----------------o--o----o-o--------------o--------------------------------------------
----------------------------o-------------------o-----------------------------------------------------------------------------------------o--------o-o----?------------------------o-----------------o--
-------------------------o----------------------------------------------------o-----------------------------------------------------------?----------?-------------M-----------------o-----------------v
---X-----------------X----------------------------X--X--------------X-------------X--?----------------------------X----------------XX-----------X----------------X-----------------------X-------------f
--------------------------X--------------X--------M---?-------------X---------------------------XX-------------------X-------------------------------------?------------------M-----------------X?-----f
-------------X----------------------------------------------------------------------------?----------------------------------------------------X-------------X-----------------------------XX----------f
-------X-----------------------------------------------------------------------X------------------------------X---------------------------------------------------X---------------------------X--------f
----------------X----X--------------------------------------X--------------------M--------X-X------------------------------------------------X---------X----X-------------X----------------------------f
--------------------------------X----------------M-------------------------------------X-----X---------------------------------------------------------------------M----------------X------X-----------f
m---------X--E--M--X---------------------X-----E--M-----X-----E-------------------X--X------------E----------X--------------------------------------------E--------E-------?-X---------E-----------X---X
X-----X---XX---X------XXX--X--X--X---X-----X--X----XX-------X--XX-X--XXX----X--X-X-X--------------X--X---X--X-----X------XXXXXX--------X----X-X-X--X-X----XX---X---X-----XX-----X------XX-XX---X-X-XX--X
