-----------------------------------------o-----------------------------------------------o-------------------------o---------------------------------------------o--------------------------------------
-------------------------o------------------------------o-----------------------------------------------------------------------------------------------------o------------------------------o----------
--------------------------------------------------------------------------------------------------------------------------------------------------o-----------------------------------------------------
-----------------------------------------------------------------------------------------------------------------------------------------------------------------------------------o--------------------
-----------------------o-----------------------o--------------o-------------------------------------------------------------------------------------------o--------------------o------------------------
----------o------------------------o--------------------------------------------------------------------------------------------------------------------------------------------------------------------
-----------------------o--------------------------------------------------------------------------------------------------------------------------------------------------------------------------------
-------------------------------------------------------------------------------------------------------------------------------------------------------------------------------------------------------v
--------------------------------------------------------------------------------------------M----------------------------------------------------------------------------------------------------------f
----------------------------M--M-----X?X---------------------------M-----------------------------------------------------------------------------------------------------------------------------------f
-----------M-----------------------M--M-M---------------------------------------------------------------------------------X?X--------------------------------------------------------------------------f
---------------------------X?X---------X?X----------------------M----------------------------------------------------------------M--------------X?X----------------------------------------------------f
-------------------M--------------------M-----------------------------X?X---------X?X----X?X-----------------X?X-------------X?X-----------------------------------------X?X---------------------------f
-------------------------------------------------------X?X------------------------------------X?X-------------------X?X----------------------------X?X-------------------------------------------------f
mE-----------------------------------M----------------------E-----------E------------------------------------------E-X?X---E--------------------------------E------------------------------------X?X---X
XXXXXXXXXXXXXXXXXXXXXXXXXXXXXXXXXXXXXXXXXXXXXXXXXXXXXXXXXXXXXXXXXXXXXXXXXXXXXXXXXXXXXXXXXXXXXXXXXXXXXXXXXXXXXXXXXXXXXXXXXXXXXXXXXXXXXXXXXXXXXXXXXXXXXXXXXXXXXXXXXXXXXXXXXXXXXXXXXXXXXXXXXXXXXXXXXXXXXXXX
