---------------------------------------------------------------------------------------------------------o---------o------------------------------------------------------------------------------------
--------------------------------------------------------------------------------------------------------------------------------------------------------------------------------------------------------
----------------------------------------------------------------------------------------------------------------------------------------------------------------------------o---------------------------
---------------------------------------------------------------------------------------------------------------------------------------------------------------------------------------o----------------
-----------------------------------------------------------------------o--------------------------------------------------------------------------------------------------------------------------------
-----------------o-----------------------------------o--------------------------------------------------------------------------o-----------o-----------------------------------------------------------
------------------------------------------------------------------------o----------------------------------o--------------------------------o-----------------------------------------------------------
------------------------------------------------------------------------------------------------------------o------------------------------------------------------------------------------------------v
-------------------------------------------------------------X?X-------------M-M----------------M---------------X?X---M--------------------------------------M---------M-------------------------------f
-----------------------------------------------------MM---M-----------------------------------------------------------X?X-----------------M------------------------------------------------------------f
---------------------------X?X-------------------------------------------------X?X--------------------------------M--------------------------X?X--------------------------M----------------------------f
--------------------------------------------------------------------------------------------------------------X?X-----------------X?X---------M--------------------------------------------------------f
---------M-------------------------------------------------------X?X--------------------------------------------M-------------------------------------M---------------------------------------------M--f
---------M-----------X?X---------------------------------------M-------------------M---------M---------------------------------------------------M----------M------------------------------------------f
m---E--E-------------------E------------------------------------X?X-------E-X?X---X?X-----------------------------------------------X?X----------M--------E------------------------E-------------------X
XXXXXXXXXXXXXXXXXXXXXXXXXXXXXXXXXXXXXXXXXXXXXXXXXXXXXXXXXXXXXXXXXXXXXXXXXXXXXXXXXXXXXXXXXXXXXXXXXXXXXXXXXXXXXXXXXXXXXXXXXXXXXXXXXXXXXXXXXXXXXXXXXXXXXXXXXXXXXXXXXXXXXXXXXXXXXXXXXXXXXXXXXXXXXXXXXXXXXXXX
