-----o--------------------------------------------------------------------------------------------------------------------------------------------------------------------------------------------------
--------------------------------------------------------------------------------------------------------------------------------------------------------------------------------------------------------
-------------------------------------------------------------------------------o-----------------------------------------------------------------------------------------------------------------o------
---------------------------------------------------------------------------------------------------------------------------------o-----------------------------o------o--------------o------------------
--------------------------------------------------------------------------------------------------------------------------------------------------------------------------------------------------------
---------------------------------------------------------------------------------------------------------o----------------------------------------------------------------------------------------------
---------------------------------o----o-----------------------------------------------------------------------------------------------------------------------------------------------------------------
--------------------------------------o--------------------------------------------------------------------------------------------------------------------o---------------------------------o---------v
-?X-----------------------M-----------M-------------------------------------------------------------M-------------------------M---------------------------M---------M---------------------X?X----------f
---------X?X----------------------------------M---------------------------------MX?X------------------------------------------------X?X------------------------------------M---------------------------f
--M---------------------------------------M---------X?X--------------------------------------M---------------------------------------------------------------------------------------------------------f
--------------------------------------------------------------------------------------------X?X--------------------------------------------------------------------------------------X?X-------M-------f
--------------------X?X---M----------------X?X------------------------------------------X?X--------------M------M--------------------------------------------------------X?X---------------------------f
------X?X-----------------M-M---------X?X----------------------------------M-------------M-------------------------------------------------------------------------------------------------------------f
m---------------------------------E-----------M--------------------------------------------------E-----M-------------------------X?X------E--------M---------------------------------------------------X
XXXXXXXXXXXXXXXXXXXXXXXXXXXXXXXXXXXXXXXXXXXXXXXXXXXXXXXXXXXXXXXXXXXXXXXXXXXXXXXXXXXXXXXXXXXXXXXXXXXXXXXXXXXXXXXXXXXXXXXXXXXXXXXXXXXXXXXXXXXXXXXXXXXXXXXXXXXXXXXXXXXXXXXXXXXXXXXXXXXXXXXXXXXXXXXXXXXXXXXX
