----?----M--------------------------------M----------------E---------M----M----------------------------------?-E------------------------?-?---E--M--------------------M-----------?--?------------------
---------------------------------------?------E-----------------------M----E--------------------------------------------------------M-----------------M-------------------------------------------------
----------------------------------------------------------------------?---------M------------E--------------------------------------------E------------?--------E---------------------------------------
------------------------------------------------?-------------------------------------------M-------------------------------E---------------------------------------------------------------------------
--------------------------------------------------------------?---------------------------------M----------------------------E--------------------------------------------------------------M-----------
-------------------------------------------------------------------------------------------------------------------------------------------------------M--------------?---------------------------------
------------------------------------------------------M-------------------------------M--------------M-----------E---?--------M---------------------------------------?---------------------------------
--------------------------------E-------------------------------------------------------------------M-------E---------------M------------------------?---------M---------------------E-----------------v
---------------------------------------------------------------------------------E------------------E---M-----------------------------------------------?--?------------------------?------------------f
-M----------?-----M-------------------------------------?---------------------------------E----------------------M-------------------------------------------M-----------------------------------------f
-----------------------?--------------------------------------------------------------------------------------------------------------------M-----------------------------------------------------E----f
-----------------------E-----------------------------------E----------------------------M------E-------------------?E---------------------?-------E------------------------------------------------?---f
-----------------------------?-------------------------------------------------------?--?-------M-------?--------------------------------------------------?----------------------------?--------------f
-------------------------------------?------------------------------------M-----------------------------------------------------M----------------------------------------------------------------------f
m?------------------------?-----------------E--------------------E----------------------------------------------M-------------------------------------------------------------------E------------------X
XXXXXXXXXXXXXXXXXXXXXXXXXXXXXXXXXXXXXXXXXXXXXXXXXXXXXXXXXXXXXXXXXXXXXXXXXXXXXXXXXXXXXXXXXXXXXXXXXXXXXXXXXXXXXXXXXXXXXXXXXXXXXXXXXXXXXXXXXXXXXXXXXXXXXXXXXXXXXXXXXXXXXXXXXXXXXXXXXXXXXXXXXXXXXXXXXXXXXXXX
