-------------------------E-------E--E----------------------------------------------------------E------------------------E----------------------E--E-----E------------------E------------E-----E---------
--------E--E----------E------------------------------------E--------------------------------------------------E--------E---------------E-E----------------------------E---------------------------------
-----------------------E-------------------------------------------------------------------------------------------------------------------------------E------------------------------------------------
----E------------------------------------E--------------------------------------------------------------------------------------------------E--E-----------------------------------------E-----------E--
---------------------------------------------------------------------------------------------------E-----------------E-----------------------E----------------------------------------------------------
-------------------------------------------------------------------------------------E------------------------------------------------------------------------------------------------------------------
-----E----------------------------------------E--------------------------E-------------------------------------------------------E---------------------------------------E------------------------------
---------------------------E------E---------------------------------------------------------------E------E-----------------E---------------------------------------------------------------------------v
----------------------------------------------------------------------------------------------------------------------------------------------------------------------------------------E--------------f
-------------E-------------------------------------------------E---------------------------------------------------------E---------------------E------------E------------------------------------------f
-----------------------------------------------------------------------------------------------------------------------------------------------------E-------------------------------------------------f
------------------------------------------------------------------------------E----------------------------------------E---------------------------------------------------------------------------E---f
-----------------------------------------E----------------------------------------------------E------------E---------------------E---------------------------------------------------------------------f
-E--E------------------------------E--------------------------------------------------------------------------------E---------------------------------------------------------------------E------------f
m-----------------------------------------------------------E------------------------------------------------------------------------------------------------------------------------------------------X
XXXXXXXXXXXXXXXXXXXXXXXXXXXXXXXXXXXXXXXXXXXXXXXXXXXXXXXXXXXXXXXXXXXXXXXXXXXXXXXXXXXXXXXXXXXXXXXXXXXXXXXXXXXXXXXXXXXXXXXXXXXXXXXXXXXXXXXXXXXXXXXXXXXXXXXXXXXXXXXXXXXXXXXXXXXXXXXXXXXXXXXXXXXXXXXXXXXXXXXX
