--------------------E--------E--E----------------------------------E--------E-------E-------E----E-E--------------------------------E------------------------------E-----------E---------E--------------
---------------E----------------------------------------------------------------------------------------------------------------------------------------------------------------------------------------
------------------------------E--------------------------------------------E-------------------------E--------------------------------------------------------------------------------------------------
------------------------------------------------------E-------------------------------------------------------------------------------------E-------------------------E---------------------------------
--------------------------------------------------------------------E---EE----------------------------------------------------------------------E--------------------E----E-----------------------------
----------------------E----E--------------------------E----------------E--------------------------------------------------------------------------------------------------------------------------------
-------E-----------------------------------------------------------------------------------------------------------------------------------E---------E-------------------------------------E------------
-------------------------------------E-------------------------E--------------------------------E------------------------------------------------------------------------------------------------------v
--EE--------E--------------------E-------------------------------------------------E--------------------------E---------------------------------------------------E------------------------------------f
----------------------------------------------------------------------E--------------------------------------------------------------------------------------------------------------------------------f
--------------------------------------------------------------------------------------------------E----------------------------------------------------------------------------------------------------f
-------------------------------------------------------------------------------------------------------------------------------------E-----------------------------E-----------------------------------f
--------------------------------------------------------------------E------------------------------------------E---------------------------------------------------------------------------------------f
----------------------------E----------------------------------------------------------------------E-------------------E-------------------------------------------------------------------------------f
m-------------------------------------E---------------------------------E-----------------------------------------------------------------------EE----E--------E-------------------------E-------------X
XXXXXXXXXXXXXXXXXXXXXXXXXXXXXXXXXXXXXXXXXXXXXXXXXXXXXXXXXXXXXXXXXXXXXXXXXXXXXXXXXXXXXXXXXXXXXXXXXXXXXXXXXXXXXXXXXXXXXXXXXXXXXXXXXXXXXXXXXXXXXXXXXXXXXXXXXXXXXXXXXXXXXXXXXXXXXXXXXXXXXXXXXXXXXXXXXXXXXXXX
