--------------------------------------------------------------------------------------------------------------------------------------------------------------------------------------------------------
--------------------------------------------------------------------------------------------------------------------------------------------------------------------------------------------------------
--------------------------------------------------------------------------------------------------------------------------------------------------------------------------------------------------------
--------------------------------------------------------------------------------------------------------------------------------------------------------------------------------------------------------
--------------------------------------------------------------------------------------------------------------------------------------------------------------------------------------------------------
----------------------o---------------------------------------------------------------------------------------------------------------------------------------------------------------------------------
---------------------------------------------------------------------------------------------------------------------------------------------------------------------------------o----------------------
------------------------------------------------------------------------------o------------------------------------------------------------o-----------------------------------------------------------v
------------------------------X?X-----------X?X---------------------------X?X---------------------X?X-------M--X?X---------X?X----------------------------------------------------X?X--M---------------f
-?X-----X?X---MX?X-M----X?X-------------M----M--------X?X-------X?X----X?X----M--M--M---------------X?X---M-------M--X?X----X?X---X?X------------X?X?X-----------------M-X?X---------X?X---------M-----f
---------M---M------------------------M-----MX?X----------MX?X---X?X------------M----------X?X--------------------M--------X?X---X?X-------X?X--------M-------------------M-X?X--MX?X----X?X----X?X----f
--M------X?X--------M------X?X?X-----X?X------X?X--X?X---------------MX?X?X---------X?X------X?X-------X?X---X?X--------------------X?X------X?XM-M----------------------------------------------X?X---f
---------M-----------M---------------X?X-X?X---X?X?X?X----------------M-------X?X-----X?X-M-----M------------------------------------------------------------X?X----X?X-M----X?X----------------------Mf
----M--X?X-----------------------------M---M--X?X-----------------X?X---M--M------------M---M---------X?X------------MM---------------X?X----------------M--------------X?XM----X?X-M-X?X--------------f
m---E--------E-E------M---M-E-------M-E-E----M-----------EE-M---------E--------------E--E------------M-------------E--M--------M-----------M--M--E-E---------M-------E--------E--------E-E-----E---M---X
XXXXXXXXXXXXXXXXXXXXXXXXXXXXXXXXXXXXXXXXXXXXXXXXXXXXXXXXXXXXXXXXXXXXXXXXXXXXXXXXXXXXXXXXXXXXXXXXXXXXXXXXXXXXXXXXXXXXXXXXXXXXXXXXXXXXXXXXXXXXXXXXXXXXXXXXXXXXXXXXXXXXXXXXXXXXXXXXXXXXXXXXXXXXXXXXXXXXXXXX
