-------------------------------------------------------------o------------------------------------------------------------------o--------o------------------------------------------------o-------------
----------------------------o-----------------------------------------------------o----------------------------------------------------------------------------------------------o----------------------
-----------------o-------------------------------------------o------------------o----------------------------------------------------------o------o----------------o------------------------------------
---------------------------------------------------------------------o------------------------------------------------------------------------------------------------o---------------------------------
--------------------------------------------------------------------------------------------------------------------------------------------------------------------------------------------------------
----------o----------------o------------------------------------------------------------------------------------------------------------------------------------------o--o-----------o------------------
----------o---------------------------------------------------------------------o------------------------------------o----------------------------------------------------------------------------------
----------------------------------------------------------------------------o--------------------------------------------------------------------------------------------------------------------------v
--------------M------------------X?X--------------------------------------------------------------------------------------------------M----------------------------------------------------------------f
------------------------------------------M---------------------------------------------------------------------------------------------------------------M--------------------------------------------f
------------------------------------------------------------------------------------------------------------X?X-------------------------------M-----------X?X------M-----------------------------------f
------------X?X-------------------X?X---------------------------M-----------------------------------------------------------X?X--------------------------X?X--------------------X?X-------X?X----------f
-------X?X--------------------------------------X?X--------------------------------------------------X?X--------------X?X-------M------------------------------------------------------------M---------f
-----------------X?X-------------------------------------------------------------------X?X------------------X?X---------------------------M----------------------------X?X----------X?X----------------f
m------------M----------------------EE-----------E--------------------------------------------------------------MM-E---------------------------------------M----------E-------M------------------------X
XXXXXXXXXXXXXXXXXXXXXXXXXXXXXXXXXXXXXXXXXXXXXXXXXXXXXXXXXXXXXXXXXXXXXXXXXXXXXXXXXXXXXXXXXXXXXXXXXXXXXXXXXXXXXXXXXXXXXXXXXXXXXXXXXXXXXXXXXXXXXXXXXXXXXXXXXXXXXXXXXXXXXXXXXXXXXXXXXXXXXXXXXXXXXXXXXXXXXXXX
