------------------------------o---------------?-----------------------------------------------------------o--------------------M---------------o----?--------o------o-M---------------------------------
---------------------------------------------------------------o------------------M------------------------------------o--------------------------------------o---------------------o-------------------
-----------------------o---------o------o---------o---------------------------o--------o---o--------------------------------------------------------------------------------------------o---------------
--oo------------------------------------------------------------------------------------------------------------------------o-------------------------------------o--------o--------------M-------------
------------o---------------------------o---------------o-------------------------------------------------------------------o----o--------------------o-----M---------------------------o-----o--o------
-----------------------------------?-o-?o-------------------------------oo------------------------------o--------------o----------o--o----o-o-----------------------------------------------------------
----------------------------o-------------------o------------------------------------o-----------o-------------------------------------------------o-o----?---------------------------------------------
-------------------------o--------o------------------------------------------------------------------------------------------------------------------?-------------M-----------------o-----------------v
---X----------------------------------------X-----X-------------------------------X--?----?----------------------------------------X------------X----------------X-------------------------------------f
---------?----------------X-----------------------M---?-------------X---------------------------XX-------------------X-------------X-----------------?-----?------------------X-----------------XX-----f
-------------X----------------X-----------------------------------------------------------?-------------------------------------------X--------X-------------X---X------------?------------X-----------f
--------------------------------------------------X----------------------------X------------------------------X----------------------------------------X----------X-----------------------X--MX--------f
-------------------X-X--------------------------------------X-------------------------------X------------------------------------------------X---------X------------------X----------------------------f
-----------------------------------------------------------------------X---------------X---------------------------------------------------------------------X-----M----------------X------X-----------f
m------------------X----------------------------?-M-----X-----E----------------------X-----------------------X----------------------------------------E------------E----X--?-X---------E-----------X---X
X-----X---XX----X------XX--X-XX--X----X---XXX------XX-------X-----X--XXX----X--X-X-X------------X--------X--X----XX-------X-XXX--------X------X----X-X----XX---X---X----XX------X------X--XX---X-X-XX--X
