---------o------------------------------------------------o---------------------------o---------o-------------------o----------------------------------------------------o------------------------------
--------------------------------------------------------------------------------------------------------------------o-----------------------------------------------------------------------------------
--------------------------------------------------------------------------------------------------------------------------------------------------------------------------------------------------------
------------------------------------------------------o------------------------------------------------------------------------o-------------------------------------o----------------------------------
----------------------------------------------------------------o---------------------------------------------------------------------------------------------------------------------------------------
---------------------------------------------------------------------------------------oo------------------------------------o------------------------------------------------------------------------o-
--------------------------------------------------------------------------------------------------------------------------------------------------------------------------------------------------------
---------o---------------------------------------------------------------------------------------------------------------------------------------------------------------------------------o-----------v
---------------------------------------------------------------------X?X-------------------------------------------------------------------------------------------------------------------------------f
-----------------------------------------X?X---------------------------------------------M------------------M----X?X-----------------------------------------------------------------------------------f
-----------M----------M---------M---------------X?X-----X?X-------------------------------------------------------------------------------------------------X?X----------------------------------------f
-------------M--------------------------------------------------------M-------------------------------------------------------------M----------------------------------X?X--------------X?X------------f
--------------------------------X?X------------------------------------------------------------------------------X?X------------------M----------------------------------------------------------------f
-------------X?X-----------------------------------------M--------------------------------------------------------------------------------------------------------M---------M--------------------------f
m-------------------------------M-----------------------M-M----------------------------------------------M------------------M---------E---------------------------M---------------E--------------------X
XXXXXXXXXXXXXXXXXXXXXXXXXXXXXXXXXXXXXXXXXXXXXXXXXXXXXXXXXXXXXXXXXXXXXXXXXXXXXXXXXXXXXXXXXXXXXXXXXXXXXXXXXXXXXXXXXXXXXXXXXXXXXXXXXXXXXXXXXXXXXXXXXXXXXXXXXXXXXXXXXXXXXXXXXXXXXXXXXXXXXXXXXXXXXXXXXXXXXXXX
