------?------M-------M--M------?--------------------------M-----------------------E?-E------M--------?-----------------E--------------?----------------E-------------?-----------------E----------------
-----------?---------E-------E-----------------------------------------?-------M---------------------M----E---?-------------------------------------------------?---------------------------------------
---E---------------------------------------------------------------------E-----------------------------------------------------------E-M-----------------------------------------------?----------------
-------------------------------?---------------------------------------------------------------------------------?-----------------------------E--------------------------------------------------------
----------------------------?------------------------M-------------?-------------------------------------------------------------?------?------------E-------------E--------?---------------------------
-----------------------------------E-------------------------------------E----------------------------------E---------------------M---------------?-----------------------------------------------------
----------M--EM---------------------------------------------------M--------------------------E------------------?------------------------------------------?--------------------------------------------
--------------M---------------------------------------------------------------------------------------------------------E------------------------------------------------------------------------------v
-----------------M-------------E----------------M---------------------------?----E---------------------------------?---------?----------------------------------M-------------------?-------M-?--------f
---------------------------------------------------------------------------------------------------------------------------?------------------------------------------------------------?-----?--------f
--?------------M----------?--------?--------------------------E---------------------E--------------------------------------------------------------------------------------------------E---------------f
------E---?-------------------------------?--------------------------------E------------------E------------------?-----------------------------E--------------?--?----------?--M-----------M-----------f
--------------------M---------------------?-M-E-------------------------------------------------------------------------------------M----------------------------------E------------------EM-----------f
-E------E-------------------------------------------------------------M----------------------?---------------------------------------------------------------E-----------------------------------------f
m----------------------?------------------------------------------------------M------------------------------------------------------M-----------------------------------------------------------------X
XXXXXXXXXXXXXXXXXXXXXXXXXXXXXXXXXXXXXXXXXXXXXXXXXXXXXXXXXXXXXXXXXXXXXXXXXXXXXXXXXXXXXXXXXXXXXXXXXXXXXXXXXXXXXXXXXXXXXXXXXXXXXXXXXXXXXXXXXXXXXXXXXXXXXXXXXXXXXXXXXXXXXXXXXXXXXXXXXXXXXXXXXXXXXXXXXXXXXXXX
