----E---------EE---------E----E--------E--------E-----------------E-----------------------------------------E----E-----EE-----------------E---------E---------------------EEE--------------E------------
------E--------E--------E-------------------------------------------E-----------------------------E---------------------------------------------------------E--------------------------------E----------
--E----------------------------------------------------------------------------------E-------------E-----E---------------E----------------E-----------------------------------------E-------------------
---------------------------E---E----------------------E--------------------E---------------------------E-----------------------------------------E------------------------------------------------------
----------------------------------------E---------------------------E--------------------------------E--------------------------------------------------------E-----------------------------------------
-----------E--E------------E---------E--------------------E------------------------------------------------------------------------------------------------------------------E--------------------------
------E-----------------------------E----------------------E----------------------------------E-------------------E----------------------------------------------------------------------------E--------
-------------E--------------------------------------------------------------------------------------------------------------E---E-----------------E----------------------------------------------------v
------------E------------------------------------------------------------E---------E-------------------------------------------------------------------------------------------------------------------f
--------------------------------------------------------E------------------------------------------------------E------------------E----------------------------------E---------------------------------f
-----------------------------E----------E-----------------------------------E------------------E---------------------------------------------------E----------------------------------------------E----f
--------------------------E---------------------------E-------------------------------E-----------------------------------E---------------E------------------------------------------------------------f
---------E--------E-----------------E-E-------------EE----------------E--------------------E--------------------------------------------------------------------------------------------EE---E---------f
--------------------E--------------------------------------------------------------------------E--------------------------------E---------------------------------------------E----------------------E-f
m------------------------------------------------------------------E----------------------------------------------E---------------------------------------------------E-----------E--------------------X
XXXXXXXXXXXXXXXXXXXXXXXXXXXXXXXXXXXXXXXXXXXXXXXXXXXXXXXXXXXXXXXXXXXXXXXXXXXXXXXXXXXXXXXXXXXXXXXXXXXXXXXXXXXXXXXXXXXXXXXXXXXXXXXXXXXXXXXXXXXXXXXXXXXXXXXXXXXXXXXXXXXXXXXXXXXXXXXXXXXXXXXXXXXXXXXXXXXXXXXX
