--------?M-?---M---?-?-----?--M?---------?M--------------------?-------?----------M-------M-----M------M??--?------?-?-?-----------------MM---------?--MM-------------M------?M-------------------------
----M--------------------------------??----------------------?-M-------------------M--------?--------------------------M-----------------?----?----?-----------M----------------------------------------
-----------M----------------------------M-------------M------------------------?--?---M--------------------------------M--------------------M--------------?--------?-----------------------M-----------
--------------?-------M--?-----------?--?----?--------------?--------------?---------------------M------M-----------------------------------M-------------------?-------------------------------?-------
----M--------------------?-----------M------------------------------------M---------------------------------------M---------?------------------------------------------------?-----M--------------------
----------------M---------------------------------------------M------?-------------------------------?--------------M----------------------------M-------?------------------?----------------M-M--------
--M-------?--------------------------M--------------------------------M---------M-----------------------------------------------------M--------------------------------?-M------------------------------
------------M------M--------------------M-------M------------------------------------M----?---------------------------------------------------?----M---------?------------------M--------?MM-----------v
------------M-------------------M-----------------------------------------------M---?--------------------------------------------------M------------------------------M----------------------------M---f
--------M---------------?----------------?---------------------------M-------------------------------------------------------M--?----------M----------M----------?-------------M------------?----------f
-------M----M----------M?----------------------------------M-M-----?--------M----------------------------------------M-M------------------?---------M-?-M--------------------M----?--?----------?----?-f
-------------M------------?-----------------M--------------------M-------?M----------------M------------?-------------?---M----M--?M----------M-?------------------------------------------------------f
---------------------M------------------?--------------------M-------------M-----?--?-----------------------M---?-----?------M-------------------------------------------------------------?-----------f
------------?---------------------M-----------M-----------M-------------------------------------------------------------?------?-----------?---?----------?----------?-----------?--------M-----M------f
m----------E------------------M--E--------------------------------------M---E-M-----E--------------------E---E--------------------E---------------------?EE-------------MM---M---M---E--E--------?-----X
XXXXXXXXXXXXXXXXXXXXXXXXXXXXXXXXXXXXXXXXXXXXXXXXXXXXXXXXXXXXXXXXXXXXXXXXXXXXXXXXXXXXXXXXXXXXXXXXXXXXXXXXXXXXXXXXXXXXXXXXXXXXXXXXXXXXXXXXXXXXXXXXXXXXXXXXXXXXXXXXXXXXXXXXXXXXXXXXXXXXXXXXXXXXXXXXXXXXXXXX
