----?--------------------------------?--------?------o--------------------o----M--------??-----M-------------o-----------------M----------------------o----o---M------------------o-M-----o-------------
----------------------------------o---------------------------o?-------------------------oo----------------------o--------------------------------------------------------------------------------------
----------------------------------------o-------------------------------------------o---------------------------------------------------------o-------------------------o-----------------------o--o----
------------------------------o----o------------------------------------------------o-------------o----------------------------------?--------o---------o-------------------------------------o---------
-------o-----o----------------------------------------o-------------------------------o------o----------------------------------------------------------------M--------------------o--------------------
-----------------------------------------------------o--------------?o-------o---------------M------------------o-----------------------------------?---------------------------o-----------------------
----------------------o------------------------------o----------?------------------o--------------------------------------------------------------------------------------------------------------------
---------------------------------?------------o----o------------------o---Mo-----------------------o------o---------------o---------o--------------o----------------------o-------------o-------------ov
------X----------X-X---------------X--------X--XM---------------X--------------X---X-----X--------------------------------------X--------X----------------M-------X------------------------------------f
----?-------------X-----------------------M---------X--------------------------------------------------------X------X-----X----------------X------------X--?------------------------------X---------X--f
----X-------X----------X--------------------------------------------------------------------M----------X--------M-----------------------------------M--X-----------------------------------------------f
----------------------X---?-----------X------------------------?--------------X-----------X----X--X-----------------------------X----------X--------X----X--------------------------------?------------f
----------------X---X---------------------------X------------------------------?-------------------------X------------------------------X-----X-------------------MX------X-M---X----X------X--X-------f
----------------------X---X----------------------X--X-------------------------------------------------?-------------M---M-----------------X-X-----------X-----------------XM------?----------X---------f
m---------------------------------------E------------------------------------------------X-----------E------------X------------E-------E---XX-----E--------EE-------------X---------E-X----------------X
X-X--XX--------X--XX-XX---X-------X------X----X---------------X-----X--X----------X-----X-----X--X-X-X--X----X---X-X--X----------X--XX------------X-X-----------X----------XX-----------X-------X------X
