--------------------------------------------------------------------------------------------------------------------------------------------------------------------------------------------------------
--------------------------------------------------------------------------------------------------------------------------------------------------------------------------------------------------------
--------------------------------------------------------------------------------------------------------------------------------------------------------------------------------------------------------
--------------------------------------------------------------------------------------------------------------------------------------------------------------------------------------------------------
--------------------------------------------------------------------------------------------------------------------------------------------------------------------------------------------------------
--------o----------------------------o------------------------------o-----------------------------------------------------------------------------------------------------------------------------------
--------------------------------------------------------------------------------------------------------------------------------------------------------------------------------------------------------
-------o----------------------------------------------------------------------------------------------------------------------o--------------------------o---------------------------------------------v
---X?X-M-------------------------X?X---------X?X-------X?X--X?X--------X?X---------X?X---------------------------X?X----------------------------------------------X?X------X?X-------------X?X---------f
-M-------------M----------------------------X?X------M------------------------------------------X?X-----M-------X?X-------X?X------X?XX----------------------X?X---X?X---------------------------------f
--?X------------M------X?X----------M--M----M-MM--X?X-------------------MM-------------X?X----------M---M-M-----MM-------X?X-------X?X-----------X?X--------X?X-----X?X------X?X---------------M--X?X--f
-------------------------------X?X-X?X-----X?X---M------X?XX?X---X?X----X?X-------M-X?X------------X?X-----M-------MM---M---M-M-M------M----------M----M------X?X-X?X-------------X?X---M--------------f
--X?X---------------X?X----X?XM-------------------M-M-------------------M-------X?X-X?X-----------X?X-------------------------------------M----------X?X---X?X-----M--------------M---------X?X--------f
-------------------------X?X--------------X?X-------M----------------M--------------X?X---M----------------M------M---M--------X?XM---X?X---M---MX?X--X?X-X?X---------------------M-M----MX?X--X?X-----f
m--M--E--E----M----E----E-----E---------M-M---M-----E-E-----M---E-------------------M--M-E---M---------E------M---EEME---EEE---M------EM--M-E-E--E-----M---E------M-------M--E--------E-E--------E-----X
XXXXXXXXXXXXXXXXXXXXXXXXXXXXXXXXXXXXXXXXXXXXXXXXXXXXXXXXXXXXXXXXXXXXXXXXXXXXXXXXXXXXXXXXXXXXXXXXXXXXXXXXXXXXXXXXXXXXXXXXXXXXXXXXXXXXXXXXXXXXXXXXXXXXXXXXXXXXXXXXXXXXXXXXXXXXXXXXXXXXXXXXXXXXXXXXXXXXXXXX
