------?------------?-----------------M--------------------E-------E----------------------------?-------?------E-----------------------?---M-----------M------EM---------------------M------M------------
-------------------------------------------------------------------------------------------------------?M---------------------------------------------------------M-------------------------------------
--------------?---------------------------------------------------------------M----------E--------------E-----------------------------------------------------------------------------------------------
-------------------------------------------?----------------------------------------------------------------------M-------------------------------------------------------------------------------------
-------------------------E--------E---------------------------------------------------------------------------------------?-------------------------M?--------------------------------------------------
---------------M-------------------------------------------------------------------E----E-----------------------M------------E---------------------ME------E--------------------------------------------
----?--------------------------------------M-----------------------M------------------------------?-------------------------------------E-------------------E-------------------------M-M---------------
-----------M----------M---------------------------------------M-----------------?--------------------------------------------------E-------------------------------------------------------------------v
----------------------EM-----------------------------------------------------------------------------------------------------------------------------------M---------?---------------------------------f
---------------------------------------------------------------?-------------------------------------------------------------------------?--------------------------E----------------------------------f
--------------M--------E----------------?---?----------------------?---------------?---------------------------------------------?-----------------------------------------M---------------------------f
------M---------------------------------------M-----------------------------------------?----M----------------------------------------------M-----------------------------M------------------------?---f
-E-------------------------------------------------------------------------------M--E--------------?---------------------------------?-----------------------------------E-------------------M-------M-f
-----------------------------------------?----------------------------E----?-------------------------------------------------------------------------------------------E------------------?------------f
m--------?-------------------------?--------------------------------------------------------------E------------------------------------------------------------------E-----M--------------E------------X
XXXXXXXXXXXXXXXXXXXXXXXXXXXXXXXXXXXXXXXXXXXXXXXXXXXXXXXXXXXXXXXXXXXXXXXXXXXXXXXXXXXXXXXXXXXXXXXXXXXXXXXXXXXXXXXXXXXXXXXXXXXXXXXXXXXXXXXXXXXXXXXXXXXXXXXXXXXXXXXXXXXXXXXXXXXXXXXXXXXXXXXXXXXXXXXXXXXXXXXX
