-E-----------E---------E--------------------------------------E----------------------------------E--E------E-----------------E--E--E--E-----------------E-----------------------------------------E-----
-------------------------------------------E----------------------------------------E--------------------------------------------------------------E----------------------------------------------------
---------------------------------------------------------------------------------------------------------------E----------------E-------------------E-----------------------------E---------------------
-------------------E------------E------------E-------------------E------------E---------------------------------E-E------------------------------------------------------------E----------------------E-
--E---------------------------------E----------------------------------E------------------------------------E--------------------------------------------------E----------------------------E-----------
-------------------------------------------------------E---------------------------------------------------------------------------------E-------------------------------E------------------------------
----------------------------------E-----------------------------------E---------------------E-----------------------------------------------E-------------------------------------------E---------------
----------------------E------------------------------------------------E------------------------------------------E------------------------------------------------------------------------------------v
-------------------------------------E---------------------------------------------------------------E-------------------------E-----------------------------------------------------------------------f
----------------------------------------------------------------------------------------------------------------------------E--------------------------------------------E------------E----------------f
-----------------------------------------E---------------------------------------------------------------------E---E----------------------------------------------------------------------------------Ef
-----------------------------------------------------------------------------------------------------E-E-----------------------------------------------E------E-----E-----E------------E---------------f
------------------------------------------------------------------------------------------------------------------------E----------------E-------------------------------------------------------------f
-----E----------------------------------E--------------------------------------------------------------------------------------------------------------------------------------------------------------f
m-----------E---------E---------------------------------------------------E-----------E---E----------E---------E--------------------------E--------------------------E----E--E-E----------E------E-----X
XXXXXXXXXXXXXXXXXXXXXXXXXXXXXXXXXXXXXXXXXXXXXXXXXXXXXXXXXXXXXXXXXXXXXXXXXXXXXXXXXXXXXXXXXXXXXXXXXXXXXXXXXXXXXXXXXXXXXXXXXXXXXXXXXXXXXXXXXXXXXXXXXXXXXXXXXXXXXXXXXXXXXXXXXXXXXXXXXXXXXXXXXXXXXXXXXXXXXXXX
