--------------------------------------------------------------------------------------------------------------------------------------------------------------------------------------------------------
--------------------------------------------------------------------------------------------------------------------------------------------------------------------------------------------------------
--------------------------------------------------------------------------------------------------------------------------------------------------------------------------------------------------------
--------------------------------------------------------------------------------------------------------------------------------------------------------------------------------------------------------
--------------------------------------------------------------------------------------------------------------------------------------------------------------------------------------------------------
--------o----------------------------o------------------------------o-----------------------------------------------------------------------------------------------------------------------------------
--------------------------------------------------------------------------------------------------------------------------------------------------------------------------------------------------------
-------o----------------------------------------------------------------------------------------------------------------------o--------------------------o---------------------------------------------v
---X?X-M-------------------------X?X---------X?X-------X?X--X?X--------------------X?X-------M-------------------X?X--X?X-----------------------------------------X?X------X?X-------------X?X---------f
-M-------------M---X?X----------------------X?X------M------------------------------------------X?X----X?X------X?X-------X?X------X?X?X---------------------------X?X-------------------------X?X-----f
--?X------------M------X?X-------------M------MM--X?X-------------------M--------------X?X-------X?XMX?XM-M-----M--------X?X-------X?X-----------X?X--------X?X-----X?X------------------------M--X?X--f
-----------------X?X-----M-----------------X?X---M------X?XX?X---X?X----XMX-------M-X?X--------------------M-------MM-------M-M-M------M----------M-----------X?X-X?X-------------X?X---M--------------f
--------------------X?X----X?XM-------------------M-M-X?X---M--X?X--------------X?X-X?X-----M-X?X------------------------------X?X--------M----------X?X---X?X-----M--------------M--------X?XX--M-----f
-----------------------X?X?X--------------X?X---M---M----------------M--------------X?X---M----------------M----M-----M----------MM---X?X---M-M-MX?X------X?X-M---------X?X-------M-M----MX?X?XX?X-----f
m-----E--EM---M----E----E-M---E---------M-ME--M-----E-E--M-----ME------------------MM--M-E---M---------E------M---E-ME---EE----M------EM--M-E-E--E---------E------M----E--M--EE-------E----------E-----X
XXXXXXXXXXXXXXXXXXXXXXXXXXXXXXXXXXXXXXXXXXXXXXXXXXXXXXXXXXXXXXXXXXXXXXXXXXXXXXXXXXXXXXXXXXXXXXXXXXXXXXXXXXXXXXXXXXXXXXXXXXXXXXXXXXXXXXXXXXXXXXXXXXXXXXXXXXXXXXXXXXXXXXXXXXXXXXXXXXXXXXXXXXXXXXXXXXXXXXXX
