--------------------------------------------------------------------------o-----o------------------------------------o---------------------------------------------------------------------------o------
---------------------------------o----------------------------------------------------------------------------------------------------------------------------------------------------------------------
----------------------------------------------------------------------------------------------------------------------------------------o-----------o---------------------------------------------------
------------------------------------------------------------------------------------------------o-------------------------------------------------------------------------------------------------------
------------------o-------------------------------------------------------------------------------------------------------------------------------------------------------------------------o-----------
------------------------------------------------------------o------------------------------------o-------------------------------------------o----------------------------------------------------------
------o---------o-------------------o-------------------------------------------------------------------------------------------------------------------------------------------------------------------
-------------------------------------------------------------------------------------------------------------------------------------------------------------------------------------------------------v
------------------------------------M------------------X?X--------------------M----------------M---------------------X?X------X?X----------X?X-----------------------------------------X?X-------------f
------------X?X--------------------------------------------------------------------------------------------------------------X?X-----------------------------------------------------------------------f
---------------------------------------------------X?X----------------X?X---------------------------------------------X?X------------------------------------------------------------------------------f
----------X?X--------------------X?X----X?X-------------------------------------------------------------MX?X-M----------------------------------------------------------------X?X--X?X-----------------f
--M----------------------------------------------------------------------------------------------------------------M-----------------------------------------------------------------------------------f
-------------------X?X-------------------------M-------------------M--------------------------------------------------------X?X------------------------------------------------------------------------f
m--------------E--------------------E------------------------------------------------M-----------------------------------------------------------------------------------------------------------------X
XXXXXXXXXXXXXXXXXXXXXXXXXXXXXXXXXXXXXXXXXXXXXXXXXXXXXXXXXXXXXXXXXXXXXXXXXXXXXXXXXXXXXXXXXXXXXXXXXXXXXXXXXXXXXXXXXXXXXXXXXXXXXXXXXXXXXXXXXXXXXXXXXXXXXXXXXXXXXXXXXXXXXXXXXXXXXXXXXXXXXXXXXXXXXXXXXXXXXXXX
