-M------M-----M---------------------------?------------M--------------?--------?----?------------------M-?-------M----M-------?-------------M-?--?------------?----M---------?-----?----------M---------
------------------------------M------------------------M--------------------------------------------M-----------------------?-M--------M---?----------------------------------------------------------?-
-----?-----M-----------------------------??------------?---------------------------------------------------------?--------M--------------------------------------?--?-----------------------------------
---------M--------------------------------------------------------------------------------------------------------------M-------------M-------?M---------------------------------------------------?----
-------------------------?--M---------------------------------------------M----------------?--------------------------------------??------?-----------?--------M----------------------------------------
----------------------M----------------------------------------------------------------------------------------------------------------------M-------------M---M?------?-M------------------------M-----
--?--M------M--------?------------------------------------------------M------M--?-------------------------------------?--------M----------------------------M-------------------------------------------
-----M----------------------------------M-------------------?------------------------M---------------------------------------?--------?-----------?---------------------------------------M------------v
------------?-------------------------------------------------------------?---------------------------------?--------------------------------------------?---------------------------------------------f
--------------------?---?-----------------------M-------------------------------------------------------------------?--------------------------------?-----------------------?---M---------------------f
--------------?------------------------------------------------------?------M------M--------------------------------------M--MM--------------------------------------M------------?--------------------f
--------------------------------------------?------------------------?--------------------------------?-----M---------?---------------------------------------------?M---------------------------------f
---------M----------------------------------------------------------?--M-----------------------------------M----------?------------------------------------------------------------------M-?-----------f
------------?----------------------?-?-------------------------------------------?-----------?---------------------------------------------?-----------M-------------------------?------------??M------f
m---??----------------------E-M--------E-E-------------E---------?----?---------?----E------------------M-------------M----------------------------M----?--------?--EE--E----M---M----M----E-----------X
XXXXXXXXXXXXXXXXXXXXXXXXXXXXXXXXXXXXXXXXXXXXXXXXXXXXXXXXXXXXXXXXXXXXXXXXXXXXXXXXXXXXXXXXXXXXXXXXXXXXXXXXXXXXXXXXXXXXXXXXXXXXXXXXXXXXXXXXXXXXXXXXXXXXXXXXXXXXXXXXXXXXXXXXXXXXXXXXXXXXXXXXXXXXXXXXXXXXXXXX
