---?--------------------------o-----------M-----------------------------------o------------------------------------o-----------M-o-------------o----?----------------------------o----------------------
----o--------------------------------------------------------------------o--------M------------o----------------------o---------------------------------------o---------------------o--M----------------
---------------o------------------------o------o-----------------------------------------o--------------------------------------o-------o---------------------------------------------------------------
---o----------------------M-o-----------------------------------------------------------------o-----------------------------o----o----------o---------------------o-----------------------M-------------
----------------------------------------------------------------------------o-------------------------------------------------------------?-----------o-----M---------------------------------o--o------
-o---------------------------------?----o-------------------------------o----------o----------------------------o------o-----------------------o--------------------------------------------------------
----------------------------o---------------o----------------------------------------------------o----o------------------------o--------------------------?----------o-o-----------o------------o-------
--------------------?-------------o-------------------------o---------------------o-------------------------------------------------------?----------?-------------M--o--------------oo----------------v
---X--X--------------X----------------------X--------X----------------------------X---------------------------------------------XX--------------X----------------------------------------X-------------f
---------?----------------------------X-----------M---?-----------------------X-------X---------X--------------------X--X-----X----------------------?-------X-----------------------------------------f
-X-----------XX---------------X------------------------------------------------------------X--X---------------------------------------------------X---------------------------?------------X-----------f
-------------X------X------------------------------------------------X---------X------------------------------X-------------------------------------------------------------------------------XX-------f
---------------------X-----X--------------------------------X-----------------------------X------------------------------------------------X-X-------------------M------X--X---------------------------f
--------------------------------X----------------M-----------------X-----------------------------------------------------------------------------------------------X-X---------------------X-----------f
m--------X------M--M-----E---?-----------X-X----?-M-----X-------------X----E--E-----------X----------?-------X-------------------------------------E------EX-------E----X--------------E--X--------X---X
X---------X----X------XXX--X-X--X-----X---XXXX-----XX--X-X--X---X----XX--X-----X-XXX-----X-X----X----X------X----XX------XX-XX---------X------XXX--XX----XX----XX--X----X--------------XX--X---X-X-XX--X
