------M--M---------------------?-----?----M----------------------------?-M--------M-?---------------?----?-M?---------------------------------------?----------------------------M----------------------
--?----------M-------------------------------------------------------------------------------------------M---------?----------------------------------------------------------------------------M-------
-----?-------------------------------?----------------M--------------------------------------------------------------------------------------------------------------------------------------?----------
---------M-----------------------------------M------------------------?--M-M----------------------------------------------------------M-----M--M---------------------?------------------------------M---
-------------------------?--------?----M-?---------------------------------------?-----------------------M------------------------?---------------------?M---M---------------?--------------------------
----------------M--------------------------M------------------M------------------------------------------M-------------------------------------------------------------------------------------M--------
-----M----?--------------------------------------------?------------------------MM--?M-------------------------------------M--?-------------------------------------------------------------------------
--M----------?-----------------------------------------------------M-----------M-------------?------------------------------------------------?--------------------------------------M-----------------v
--?---------------------------------------------------------------------------------?------M-?----M-------?----------------------------M-------------------------------------?---------------M------M--f
----------M-------?--------------------?---------------------------------------------------?--------?-----------------M--------------------M----?----------------?---------------?-----------?------?--f
-------M-------M---------------------------------------------------------------------------?------------------M----M------------------------------M--------------------------M-------?-----------------f
--------------------?-------------------------------------------------------------------------------------------------?--------M----------------?----------------?----------?------?-------------------f
---------------------M----------------------------------------------?---------------?------------------------M----M------------------------------------------------------------------------?-----------f
-------------------------------------?-------------------------M-------------M-------------------------------------------------------------------------------M-------?--------------------M-----M------f
m-----E----E---EE------E--E?M-----EM----------------------------E-------M---------E--------------------------------EE------------E-----------------------E------------------------E----------------ME--X
XXXXXXXXXXXXXXXXXXXXXXXXXXXXXXXXXXXXXXXXXXXXXXXXXXXXXXXXXXXXXXXXXXXXXXXXXXXXXXXXXXXXXXXXXXXXXXXXXXXXXXXXXXXXXXXXXXXXXXXXXXXXXXXXXXXXXXXXXXXXXXXXXXXXXXXXXXXXXXXXXXXXXXXXXXXXXXXXXXXXXXXXXXXXXXXXXXXXXXXX
