--------------------------------------------------------------------------------------------------------------------------------------------o-----------------------------------------------------------
---------------------------------------------------o----------------------------------------------------------------------------------------------------------------------------------------------------
-----------------------------------------------------------------------------------------------------------------------------oo-------------------------------------------------------------------------
-o---------------------------o-----------------------------------------------------------------o-----------------------o------o-------------------------------------------------------------------------
-----------------------------------------------------------------------------------------------------------------------------------------------------------------o--------------------------------------
------------------------------------------------------------------------------o-----o-------------------------------------------------------------------------------o-----------------------------------
---o-o---------------------------------------o----------------------------------------------------------------------------------------------------------o-----------------------------------------------
------------------------------------------------------------------------------------------------------------------o------------------------------------------------------------------------------------v
---------------------------------X?X-----------------------------------------------------------------------------------------------------------------------------------------X?X-----------------------f
--------------------------------------------------X?X-----------------------X?X------------X?X-X?X-X?X-M---------------------X?X----------------------------------X?X-------------M-------------------Mf
---------------------MX?X---------------------------------------------------X?X--------------------------------------M--------------------------------------------------------------------------------Mf
-----------------------X?X----------------------------M---------------------------------------------------------------------------------------------X?X----------------------------------------------M-f
---------------------------M-------X?X------------------------------------------X?X-----------------------------------------------------------------X?X------------------------------------------------f
--------------------------------------------------------------------------X?X------------------------------------------M-----------------------------------------MX?X-------------------------------M--f
m---------------M---------------M------------M---------------------X?X------------------------------------------------X?X-------------------------------EM---------------------------------------------X
XXXXXXXXXXXXXXXXXXXXXXXXXXXXXXXXXXXXXXXXXXXXXXXXXXXXXXXXXXXXXXXXXXXXXXXXXXXXXXXXXXXXXXXXXXXXXXXXXXXXXXXXXXXXXXXXXXXXXXXXXXXXXXXXXXXXXXXXXXXXXXXXXXXXXXXXXXXXXXXXXXXXXXXXXXXXXXXXXXXXXXXXXXXXXXXXXXXXXXXX
