--------------------------------------------------------------------------------------------------------------------------------------------------------------------------------------------------------
--------------------------------------------------------------------------------------------------------------------------------------------------------------------------------------------------------
--------------------------------------------------------------------------------------------------------------------------------------------------------------------------------------------------------
--------------------------------------------------------------------------------------------------------------------------------------------------------------------------------------------------------
--------------------------------------------------------------------------------------------------------------------------------------------------------------------------------------------------------
--------o----------------------------o------------------------------o-----------------------------------------------------------------------------------------------------------------------------------
--------------------------------------------------------------------------------------------------------------------------------------------------------------------------------------------------------
-------o----------------------------------------------------------------------------------------------------------------------o--------------------------o---------------------------------------------v
--X?XM-M---------------M---------X?X-----------------M-X?X--X?X--------------------X?X-----------M---------------X?X-------------------M--------M-----------------X?X------X?X----X?X------X?X---------f
-MM---------M--M--X?X-M-----------------M-M---------------X?X---------------------------M-------X?X-----M-------X?X--X?X--X?X------X?XX----------------------------X?X-M-------------------------------f
--?X?X----------M------X?X-------------M------MM--X?X------------X?X----M----X?X-------X?X-X?X------M--X?XM-----M-----X?XX?X-------X?X---------------------------------------------------------M--X?X--f
----------X?X----X?X--------M------M-------X?X------X?X-X?XX?X-X?X------X?X-------M-X?X----M---------------M--------M-------M-M-MM-----M-X?X------M--------M------X?X----------X?XX?X------------------f
----------------------X?X?X---M---------M---------M-X?X---------------------M-------X?X----------------------------------------X?X--------M----------X?X---X?X-X?X-M--------------M---------X?XX?X-----f
-M----------X?X----------M----------------X?X?X-----M-MX?X------------MX?X----------X?X---M----------------M-X?X--M---M-----------M---X?X---M----XMX------X?X-----------X?X-M-----M-M-X?XM-----X?X-----f
m----ME-------M---ME----E---------------M--EM-M-----EEE---------EE------------------M----E-E-----------E------M-M-E--ME----E----------E-----E-E--E-E--M---EE-----MM-------------E----EE--E---M---E-----X
XXXXXXXXXXXXXXXXXXXXXXXXXXXXXXXXXXXXXXXXXXXXXXXXXXXXXXXXXXXXXXXXXXXXXXXXXXXXXXXXXXXXXXXXXXXXXXXXXXXXXXXXXXXXXXXXXXXXXXXXXXXXXXXXXXXXXXXXXXXXXXXXXXXXXXXXXXXXXXXXXXXXXXXXXXXXXXXXXXXXXXXXXXXXXXXXXXXXXXXX
