---------------------------------------------------------------------o---------------------------------------------------------------------------------------o------------------------------------------
------------------------------------------------------------------------------------------------------------------------------------------------o---o---------------------------------------------------
------------------------------------------------o----------------------------------o----------------------------------------------------------------------------------------------------o---------------
---------------------------------------------------------------------------------------------------------------------o------------------o---------------------------------------------------------------
----------------------------------------------------------------------------------------------------------------------------------------------------------o---------------------------------------------
--------------------------------------------------------------------------------------------------------------------------------------------------------------------------------------------------------
-------------------------------------------------------------------------o--------------------------------------------o--o------------------------------o---------------------o-------------------------
--------------------------------------------o------------------------------------------------------------------------------------------------------------------------------------------------o-----o---v
----------------------------------------------------------X?X----------------------------------------------------------------------------------------------------------M----M--------------------------f
----------------------------------------------------------X?X----------------X?X----------------------------------------X?X---------------------------------------X?X----------------------------------f
------------------------------------------------------------------------------------M------------------------------------------------------------------------------------------------------------------f
-------M----------------------------------------------M-------X?X----------------M-------------------------------------------------------------M---------------------------------X?X-------------------f
----------X?X--------------------------------------------------------------------------------------------------------X?X------------M------X?X---------------------------------------------------------f
---X?X-----------------------------------------------------------------M--------X?X--------------------------------------------------------------------------------------------------------------------f
m------M------------------------------------------------------------E-----E-------------------------E---------------------------------------------------E------------E-E---------------EM--------------X
XXXXXXXXXXXXXXXXXXXXXXXXXXXXXXXXXXXXXXXXXXXXXXXXXXXXXXXXXXXXXXXXXXXXXXXXXXXXXXXXXXXXXXXXXXXXXXXXXXXXXXXXXXXXXXXXXXXXXXXXXXXXXXXXXXXXXXXXXXXXXXXXXXXXXXXXXXXXXXXXXXXXXXXXXXXXXXXXXXXXXXXXXXXXXXXXXXXXXXXX
