--o-----------------------o------------o---------o-----o------o--------------------------------------------------------o--------------------------------------------o------o-----o---------o------------
-------o------------------------------------o-----------------------------------------------------------------o-----------------------------------------------------------------------------------------
--------------------------------------------------------------------------------------------------------------------------------------------------------------o-----------------------------------------
-------------------------------------------------------------------------o--------------------------------------------------------------------------------------o---------------------------------------
---------------------------------------------------------------------------------------------------------------------------------------------------------o----------------------------------------------
--------------------------o-------------------------------------------------------------------------------------------------o----------------o----------------------------------------------------------
-----------------o-----------------------------------------o--------------------------------------------------------------------------------------------------------------------------------------------
------------------------------------------------------------------------------------------------------------------------------------------------------------------------o---o--------------------------v
------------------X?X-------------------------------------------------------------------------------------------------------------------X?X-------------------------M---------------------M------------f
-----------------M-------------------------------M-X?X--------------X?X?X-----------------------------------------------M------------------X?X------X?X------------------------------------------------f
-----------------------------------------X?X-------------------------------X?X-------------------------------------------M------------------------------------------------------------------M--X?X-----f
-----------------------------------------------------------------M-------M----------------------------------------------------M--------------------------------------X?X-------------------------------f
------------MX?X---------------------------------------------------------------------------------------------------------------------------------------------------------------------------------------f
---------------------------------------------------------X?X---------------------------------------------------------------------------------------------X?X----------X?X----------M-------------------f
m----------------------------------------E----------------M-------E----------------------------------------E-----------------------------------------------------------------------------E-------------X
XXXXXXXXXXXXXXXXXXXXXXXXXXXXXXXXXXXXXXXXXXXXXXXXXXXXXXXXXXXXXXXXXXXXXXXXXXXXXXXXXXXXXXXXXXXXXXXXXXXXXXXXXXXXXXXXXXXXXXXXXXXXXXXXXXXXXXXXXXXXXXXXXXXXXXXXXXXXXXXXXXXXXXXXXXXXXXXXXXXXXXXXXXXXXXXXXXXXXXXX
