-------------------------------------o------------o----------------------------------------------------------------?-------------o-------------------------------?---o------o---------------------------
-----------------------------------------------------------------------------------o----------------------o------o-------------------------------o-?-----------o-----o----------------------------------
-------------------------------------------------------------------------------------o---------------------------o------o----------------------------------------o---------------o----------------------
---------------o-?-----o----------------o--o-------------o----------------?------------------o---------o-o----------------------------------------------------------------------------------------------
---------------------------------o--------------------------o------o----o------------------------o-----------o-----------------------------------------------------------------o---o--------------------
---o-----------------------------------------------------o-------------------o---------------------------------------------M------o---------?-----------------------------------------------------------
-----o-----------o---------o--------------------------------------------------------------------------o----------------------------o---------M----------------o-----------------------------------------
-o-----------M-?------------------------------------o---------o--------o------------------------------------------M-----------------------------o---------------------------------------------o----o---v
---------------X-----------------------------------------X-------------------X----X-----------------------------X-----X---------------------------------M--------------------------XX----------M-------f
-----------X-------X---X---------------------------X-------------X------X-----------X--------------------?----------------------------------X------------------------------------------?---------------f
-M------------------------------------------X-----X-------X-------------------------X---------------------------------------------------------------------------------------------------X------X-------f
-----------------------------X------X---------?-------------------X-----------------------------------------------------------X----------------------X---------------------------X------------------X--f
-----X-------------?---------------------------X----------------X-------------------------------------------------------------------------------M-X-X--------X--------------------------------X--------f
---------------------------------------------------------X------?-----------------------------------X-----------X----------------------X------------------------------------X--------------------------f
m----------X--------X-----------E-------------------E------E----------------------------E-XE-----X---X-----------X---------------------------E-----------------------------EX-E--------E-------E----X--X
X------X----X-----X-X--XX-------X---X-XXXX---XX-XX--X----XX---XX-X----XXX---------X--X---X-----XX-X--------XX----X------------X---XX----XX-X-XX-X--X-X-------------X-----X-XXXX----X---X---------XX----X
