--------------------------------------------------------------------------------------------------------------------------------------------------------------------------------------------------------
--------------------------------------------------------------------------------------------------------------------------------------------------------------------------------------------------------
--------------------------------------------------------------------------------------------------------------------------------------------------------------------------------------------------------
--------------------------------------------------------------------------------------------------------------------------------------------------------------------------------------------------------
--------------------------------------------------------------------------------------------------------------------------------------------------------------------------------------------------------
--------o----------------------------o------------------------------o-----------------------------------------------------------------------------------------------------------------------------------
--------------------------------------------------------------------------------------------------------------------------------------------------------------------------------------------------------
-------o----------------------------------------------------------------------------------------------------------------------o--------------------------o---------------------------------------------v
---X?X-M-------------------------X?X-------------------X?X--X?X--------------------X?X---------------------------X?X----------------------------------------------X?X------X?X-------------X?X---------f
-M-------------M--X?X-----------M-----------MM------------------------------X?X-----------------X?X-----M-------X?X--M----X?X------X?XX----------------------------X?X---------------------------------f
--?X------------M------X?X-------------M------MM--X?X-------------------M--------------X?X----------M-----M-----M--------X?X-------X?X-------------------------------------------M-------------M--X?X--f
-------------------------------------------X?X--X?X--X?XX?X?XX----------X?X-------M-X?X-------------X?X?X--M--------M-------M-M-M------M----------M---------------X?X-------------X?X------------X?X-X?f
---------M--M-----------------M----------X?X------MX?XX---------------X?X-----------X?X---------M------------X?X----------M---------------M----------X?X---X?X-----M-X?X----------M---------X?X--------f
-------------------------X?X--------------X?X---M--X?X-----------X?X------------M---X?X---M----------------M----------M-----------M---X?X---M----X?X------X?X-------------------X?XMM----M-----X?X-----f
m-----E-------M----E----E--------------EM-----M-----E-E--E------E----M--M-----------ME---EE-----E------E-E----M---E--E--------------M-E----EE-E--E---------E------M--EE---------------E----------E-----X
XXXXXXXXXXXXXXXXXXXXXXXXXXXXXXXXXXXXXXXXXXXXXXXXXXXXXXXXXXXXXXXXXXXXXXXXXXXXXXXXXXXXXXXXXXXXXXXXXXXXXXXXXXXXXXXXXXXXXXXXXXXXXXXXXXXXXXXXXXXXXXXXXXXXXXXXXXXXXXXXXXXXXXXXXXXXXXXXXXXXXXXXXXXXXXXXXXXXXXXX
